AbathurDeepTunnel=Tunnel to a location.
AbathurEvolveMonstrosityHotbar=Minion or Locust becomes a powerful Monstrosity
AbathurLocustMasterHotbar=Create Locust Nests
AbathurLocustStrain=Spawn locusts that attack down the nearest lane
AbathurLocustStrainAssaultStrainTalent=Locusts cleave and explode
AbathurLocustStrainBombardStrainTalent=Locusts gain a ranged attack
AbathurLocustStrainSurvivalInstinctsTalent=Increases Locust Health and duration
AbathurLocustSwarm=Spawn a group of Locusts
AbathurMonstrosityEvolutionCompleteTalent=Monstrosity gains Deep Tunnel
AbathurSymbiote=Assist an ally and gain new abilities
AbathurSymbioteAdrenalOverloadTalent=Symbiote host gains Attack Speed
AbathurSymbioteAdrenalineBoostTalent=Carapace increases Move Speed
AbathurSymbioteCarapace=None
AbathurSymbioteCarapaceNetworkedCarapaceTalent=Carapace shields all nearby allies
AbathurSymbioteCarapaceSustainedCarapaceTalent=Increases Carapace shield and persists after Symbiote
AbathurSymbioteEnvenomedSpikesTalent=Spike Burst slows Move Speed
AbathurSymbioteHivemindTalent=Symbiote two targets
AbathurSymbioteNeedlespineTalent=Increases Stab damage and range
AbathurSymbiotePressurizedGlandsTalent=Increases Spike Burst range and decreases cooldown
AbathurSymbioteRegenerativeMicrobesTalent=Carapace heals target
AbathurSymbioteSpatialEfficiencyTalent=Stab gains an additional charge
AbathurSymbioteSpikeBurst=Damage nearby enemies
AbathurSymbioteSpikeBurstSomaTransferenceTalent=Spike Burst heals for each Hero hit
AbathurSymbioteStab=Shoots a spike that deals damage to the first enemy it contacts.
AbathurToxicNest=Spawn a mine
AbathurToxicNestBallistosporesTalent=Toxic Nests have global range and last longer
AbathurToxicNestEnvenomedNestTalent=Toxic Nests deal more damage
AbathurToxicNestProlificDispersalTalent=Increases Toxic Nest charges
AbathurToxicNestVileNestTalent=Toxic Nests slow Move Speed
AbathurUltimateEvolution=Clone target allied Hero and control it
AbathurUltimateEvolutionEvolutionaryLinkTalent=Ultimate Evolution target gets a Shield
AbathurVolatileMutationTalent=Heroic summons radiate damage
AlarakAppliedForce=Reduce Sadism, increase Telekinesis distance, range
AlarakBladeoftheHighlord=Basic Attacks increase Sadism
AlarakChaosReigns=<c val="#TooltipQuest">Quest:</c> Hit Heroes to increase Discord Strike damage
AlarakCounterStrike2ndHeroic=Prevents damage to deal damage in a large area
AlarakCounterStrike2ndHeroicSadism=Deal increased ability damage to Heroes
AlarakCounterStrikeTargeted=Prevents damage to deal damage in a large area
AlarakDeadlyCharge=Channel to charge a long distance
AlarakDeadlyCharge2ndHeroic=Channel to charge a long distance
AlarakDeadlyCharge2ndHeroicSadism=Deal increased ability damage to Heroes
AlarakDiscordStrike=Damage and silence enemies in an area
AlarakDissonance=Increase Discord Strike's Silence duration
AlarakEndlessEnergy=<c val="#TooltipQuest">Quest: </c>Reduces Lightning Surge cooldown
AlarakExtendedLightning=<c val="#TooltipQuest">Quest:</c> Reduce Sadism, empower Lightning Surge
AlarakHastyBargain=Activate to reduce Sadism bonus and reset Basic Ability cooldowns
AlarakHinderedMotion=Telekinesis Slows
AlarakLastLaugh=Cleanse and teleport, but reduce Health
AlarakLethalOnslaught=Discord Strike grants Sadism bonus to Basic Attacks
AlarakLightningBarrage=Center hits grant free Lightning Surge cast
AlarakLightningSurge=Damage enemies in a line
AlarakLightningSurgeLightningBarrage=Damage enemies in a line
AlarakMockingStrikes=Reduce cooldowns against disabled Heroes
AlarakNegativelyCharged=<c val="#TooltipQuest">Quest:</c> Increase Lightning Surge center damage
AlarakPureMalice=Allied deaths increase Sadism
AlarakRiteofRakShir=Mark and damage Hero to increase Sadism
AlarakRuthlessMomentum=Reduce cooldowns at high Health
AlarakSadism=Alarak's Ability damage and healing are increased against Heroes
AlarakSadismCarryFace=Alarak's Ability damage and self-healing are increased by <c val="#TooltipNumbers"><d ref="100*(($BehaviorTokenCount:AlarakSadismToken$*Accumulator,AlarakSadismAccumulator,Scale)+($BehaviorTokenCount:AlarakSadismPureMaliceQuestToken$*Accumulator,AlarakSadismPureMaliceAccumulator,Scale))"/>%</c> against enemy Heroes.<n/><n/>Sadism gained from Talents: <c val="#TooltipNumbers"><d ref="10*($BehaviorStackCount:AlarakSadism10TokenIncrease$)"/>%</c><n/>Sadism reduction from Talents: <c val="#TooltipNumbers"><d ref="10*($BehaviorStackCount:AlarakSadism10TokenReduction$)"/>%</c><n/>Sadism gained from Takedowns: <c val="#TooltipNumbers"><d ref="($BehaviorTokenCount:AlarakSadismTakedownIncreaseTokenCounter$*Effect,AlarakSadismTakedownAddTokens,Value)"/>%</c>
AlarakShowofForce=Ability combos deal bonus damage
AlarakSustainingPower=Increase Lightning Surge healing
AlarakTelekinesis=Push enemies towards a location
AlarakUnleashDeadlyCharge=Charge Recklessly
AlexstraszaAbundance=Heal allied Heroes in an area
AlexstraszaAncientFlameFlameBuffet=Dragonqueen Attacks apply Flame Buffet
AlexstraszaBlessingOfTheRed=Grant bonus Health to an ally
AlexstraszaBreathOfLife=Heal an ally
AlexstraszaCircleOfLifeAbundance=<c val="#TooltipQuest">Quest:</c> Regen Globes empower Abundance
AlexstraszaCleansingFlame=Rain healing and damaging fire from the sky
AlexstraszaCleansingFlameDragonqueen=Rain healing and damaging fire from the sky
AlexstraszaDraconicDisciplineDragonqueen=Increase Dragonqueen duration
AlexstraszaDragonScales=Gain Armor while disabled
AlexstraszaDragonqueen=Transform into a dragon aspect with empowered Abilities
AlexstraszaDragonqueenDragonFormPassive=Transform into a dragon aspect with empowered Abilities
AlexstraszaExuberance=High Health grants Move Speed
AlexstraszaFireWithinFlameBuffet=Flame Buffet restores Health
AlexstraszaFlameBuffet=Launch a fireball that ignites enemies and can Slow them
AlexstraszaFlamesOfFuryFlameBuffet=<c val="#TooltipQuest">Quest:</c> Flame Buffet reduces Dragonqueen cooldown
AlexstraszaGiftOfLife=Give a portion of Health to an ally
AlexstraszaHeatExhaustionFlameBuffet=Increase Flame Buffet Slow
AlexstraszaLifeUnbound=Heal an ally and damage enemies
AlexstraszaLifebinder=Link Alexstrasza's Health with an ally
AlexstraszaLifeblossomeGiftOfLife=Gift of Life creates a Lifeblossom at high Health
AlexstraszaLiveAndLetLiveGiftOfLife=High Health reduces Gift of Life cooldown
AlexstraszaOnRubyWingsCleansingFlame=Cleansing Flame can activate Dragonqueen
AlexstraszaOverprotectiveAbundance=Abundance grants Shields
AlexstraszaPacify=Slow an enemy Hero and reduce their damage
AlexstraszaPreservation=Heal allied Heroes in an area
AlexstraszaRitualOfLifeLifebinder=Life-Binder activates multiple times
AlexstraszaSurgeOfVitalityAbundance=Abundance grants Move Speed
AlexstraszaToughLoveGiftOfLife=Gift of Life grants Armor at high Health
AlexstraszaVerdantFlourishAbundance=Regen Globe and Abundance healing increased
AlexstraszaWingBuffet=Damage, Knockback, and Slow enemies
AmazonAvoidance=Gain Physical Armor while moving
AmazonAvoidanceChargedStrikes=Activate to empower Basic Attacks
AmazonAvoidancePlateoftheWhale=<c val="#TooltipQuest">Quest:</c> Avoidance regenerates Health
AmazonAvoidanceSurgeOfLight=Activate Avoidance to deal damage
AmazonAvoidanceWarTraveler=Avoidance grants Movement Speed
AmazonBallLightning=Throw a bouncing lightning ball
AmazonBallLightningInfiniteLightning=Ball Lightning bounces indefinitely
AmazonBlindingLight=Blind enemies in an area
AmazonBlindingLightInnerLight=Emit Blinding Light when Stunned or Rooted
AmazonBlindingLightSeraphsHymn=Basic Attacks reduce Blinding Light cooldown
AmazonBlindingLightTrueSight=<c val="#TooltipQuest">Quest:</c> Empower Blinding Light
AmazonFend=Charge at a target and rapidly attack nearby enemies
AmazonFendImpale=Increase Fend damage
AmazonFendLungingStrike=Increase Fend area, duration
AmazonFendPenetrate=Consecutive Fend hits deal increased damage
AmazonLightningFury=Hurl a lightning javelin that splits upon impact
AmazonLightningFuryGroundingBolt=Lightning Fury Slows
AmazonLightningFuryPierce=Lightning Fury pierces
AmazonLightningFuryThundergodsVigor=Reduce Lightning Fury cooldown
AmazonLightningFuryThunderstroke=<c val="#TooltipQuest">Quest:</c> Empower Lightning Fury
AmazonMartialLaw=Disabled Heroes take additional damage
AmazonRingoftheLeech=Damaging Blinded targets heals
AmazonTitansRevenge=Basic Attacks ignore Armor
AmazonValkyrie=Summon a Valkyrie to impale enemies
AmazonValkyrieImprisoningLight=Valkyrie Roots enemies
AnaAimDownSights=Activate Shrike to increase vision, range
AnaAimDownSightsCustomOptics=Increase Aim Down Sights range bonus
AnaBioticGrenade=Toss a grenade that heals allies, prevents enemy healing
AnaBioticGrenadeAirStrike=Activate to throw Biotic Grenade farther
AnaBioticGrenadeContactHealing=Increase Biotic Grenade healing on multiple Heroes
AnaBioticGrenadeGrenadeCalibration=<c val="#TooltipQuest">Quest:</c> Empower Biotic Grenade
AnaDebilitatingDart=Fire a damage-reducing dart
AnaDetachableBoxMagazine=<c val="#TooltipQuest">Quest:</c> Empower Doses
AnaDynamicShooting=Basic Attacks increase Attack Speed
AnaEyeOfHorusActivate=Fire unlimited range healing and damaging rounds
AnaEyeOfHorusBallisticAdvantage=Eye of Horus rounds explode
AnaHealingDart=Shoot a dart that heals an Ally
AnaHealingDartConcentratedDoses=Doses empower Healing Dart
AnaHealingDartEmpowerHealingDarts=Empower Healing Darts
AnaHealingDartPurifyingDarts=Healing Dart removes Roots, Slows
AnaHealingDartSharpshooter=Empower consecutive Healing Darts
AnaHealingDartSmellingSalts=Healing Dart removes Stuns
AnaHealingDartSpeedSerum=Healing Dart grants Move Speed
AnaMindNumbingAgent=Doses decrease Spell Power
AnaNanoBoost=Grant ally Spell Power, reduced cooldowns
AnaNanoInfusion=Nano Boost heals for damage dealt
AnaOverdose=Sleep Dart applies Doses
AnaPiercingDarts=<c val="#TooltipQuest">Quest:</C> Empower Sleep Dart, Healing Dart
AnaSleepDart=Fire a dart that puts enemies to Sleep
AnaSleepingDartTemporaryBlindness=Sleep Dart Blinds
AnaSomnolentDoses=Max Dosage puts enemies to Sleep
AnaTraitShrikeSniper=Basic Attacks deal additional damage over time and heal
AnubarakAcidDrenchedMandibles=Attacking disabled Heroes increases damage
AnubarakBeetleSpitBeetleJuiceTalent=Basic Attacks to Heroes spawn Beetles
AnubarakBurrowCharge=Burrow underground and charge in a direction
AnubarakBurrowChargeEpicenterTalent=Increases Burrow Charge area and reduces cooldown
AnubarakBurrowChargeUnderkingTalent=Increases Burrow Charge range and damage
AnubarakCarrionSwarm=Damages enemies while healing
AnubarakCarrionSwarmHiveMasterTalent=Gain a permanent life-stealing Locust
AnubarakCocoon=Wraps enemy in a cocoon
AnubarakCryptweaveCocoonTalent=Increases Cocoon duration
AnubarakDebilitation=Burrow Charge decreases enemy Spell Power
AnubarakHardenCarapace=Gain a shield
AnubarakHardenCarapacePersistentCarapaceTalent=Longer lasting Shield
AnubarakHardenCarapaceUrtricatingSpinesTalent=Harden Carapace deals area damage
AnubarakImpale=Shoot line of spikes that damages and stuns enemies
AnubarakImpaleBedOfBarbsTalent=Impale slows and damages over time
AnubarakLeechingMandiblesTalent=Beetles heal Anub'arak
AnubarakLegionOfBeetlesTalent=Spawn Beetles periodically
AnubarakNerubianArmor=Periodically gain Spell Armor
AnubarakRegeneratingCarapaceChitinousPlatingTalent=Reduces Harden Carapace cooldown
AnubarakRegeneratingCarapaceShedExoskeletonTalent=Harden Carapace increases Move Speed
AnubarakResilientScarabs=Beetles gain Spell Armor
AnubarakScarabHostTrait=Spawn a Beetle whenever an Ability is cast
AnubarakSubterraneanShield=Burrow Charge grants Shield
ArtanisBladeDash=Dash forward then back again, damaging enemies along the way
ArtanisBladeDashPsionicSynergyTalent=Increases Blade Dash cooldown reduction of Shield Overload
ArtanisBladeDashSolariteReaperTalent=Increases Blade Dash damage
ArtanisBladeDashTemplarsZealTalent=Blade Dash recharges faster when at low Health
ArtanisPhasePrism=Swap positions with an enemy Hero
ArtanisPhasePrismChronoSurgeTalent=Phase Prism grants Attack Speed
ArtanisPhasePrismGravitonVortexTalent=Reduces Phase Prism cooldown and pull another Hero
ArtanisPhasePrismWarpSicknessTalent=Phase Prism slows enemies
ArtanisPlasmaBurn=Shield Overload burns nearby enemies
ArtanisShieldOverloadForceofWillTalent=Increases Shield Overload Basic Attack reduction
ArtanisShieldOverloadPhaseBulwarkTalent=Shield Overload grants Spell Armor
ArtanisShieldOverloadShieldBatteryTalent=Shield Overload recharges faster while active
ArtanisShieldOverloadShieldSurgeTalentNew=Increase Shield Overload shield at low Health
ArtanisShieldOverloadTrait=Gain a Shield when attacked at low Health
ArtanisSpearofAdunPurifierBeam=Chase an enemy with an orbital beam
ArtanisSpearofAdunPurifierBeamTargetPurifiedTalent=Purifier Beam recasts if target dies
ArtanisSpearofAdunSuppressionPulse=Damage and Blind enemies in a large area
ArtanisSpearofAdunSuppressionPulseOrbitalBombardmentTalent=Suppression Pulse gains an additional charge
ArtanisTwinBlades=Charge and Basic Attack twice
ArtanisTwinBladesAmateurOpponentTalent=Increases Twin Blades damage to non-Heroes
ArtanisTwinBladesPsionicWoundTalent=Twin Blades lowers Armor
ArtanisTwinBladesReactiveParryTalent=Twin Blades gives Physical Armor
ArtanisTwinBladesTitanKillerTalent=Twin Blades deals more damage versus Heroes
ArtanisTwinBladesTripleStrikeTalent=Twin Blades strikes 3 times but increases cooldown
ArtanisTwinBladesZealotChargeTalent=Increase Twin Blades charge distance
ArthasAntiMagicShellTalent=Activate to become immune to Spell Damage
ArthasDeathlord=Reduces Death Coil cooldown and increases range
ArthasDeathsAdvanceTalent=Activate to increase Movement Speed
ArthasIceboundFortitudeTalent=Activate to gain Armor, reduce disabling effects
ArthasRemorselessWinterFrozenTempestTalent=Frozen Tempest can root enemy Heroes
ArthasAbsoluteZeroSummonSindragosaTalent=Increases Sindragosa range and disable duration
ArthasArmyOfTheDead=Raise ghouls that fight enemies, heal Arthas
ArthasArmyOfTheDeadSacrifice=Sacrifice a Ghoul to heal
ArthasBitingColdFrozenTempestTalent=Frozen Tempest damage increased
ArthasDeathCoil=Deals damage to a target or heal Arthas
ArthasEmbraceDeathDeathCoilTalent=Death Coil deals more damage when missing Health
ArthasEternalHungerFrostmourneHungersTalent=<c val="#TooltipQuest">Quest:</c> Empower Frostmourne Hungers
ArthasFrostPresenceHowlingBlastTalent=<c val="#TooltipQuest">Quest:</c> Root Heroes to empower Howling Blast
ArthasFrostPresenceToken=Root Heroes to empower Howling Blast
ArthasFrostStrikeFrostmourneHungersTalent=Reduces Frostmourne Hungers cooldown and adds slow
ArthasFrostmourneFeedsFrostmourneHungersTalents=Increases number of Frostmourne Hungers attacks
ArthasFrostmourneHungers=Activate to empower the next attack and restore Mana on hit
ArthasFrozenTempest=Damage and slow nearby enemies. Drains Mana while active
ArthasFrozenWastesFrozenTempestTalent=<c val="#TooltipQuest">Quest:</c> Frozen Tempest slow lingers
ArthasHowlingBlast=Root and damage enemies in an area
ArthasIcyTalons=Frozen Tempest increases Attack Speed
ArthasImmortalCoilDeathCoilTalent=Death Coil always heals
ArthasLegionOfNorthrendArmyOfTheDeadTalent=Ghouls last longer and more are created
ArthasRime=Periodically gain Physical Armor
ArthasRuneTapTalent=Consecutive Basic Attacks heal
ArthasShatteredArmor=Howling Blast reduces Armor
ArthasSummonSindragosa=Disables enemies and Structures
Attack=Damage enemies with Basic Attacks
AurielAngelicFlightTalent=Activate to fly to a location
AurielBestowHope=Bestowed ally's damage grants energy
AurielBlindingFlashSacredSweepTalent=Sacred Sweep blinds enemies in the center
AurielBurstingLightRayOfHeavenTalent=Reduces the cooldown of Ray of Heaven
AurielConvergingForceSacredSweepTalent=Sacred Sweep pushes enemies towards the center
AurielDetainmentStrike=Knock an enemy Hero back, stunning them if they collide with terrain
AurielDiamondResolveCrystalAegisTalent=Crystal Aegis grants Armor
AurielEmpathicLinkBestowHopeTalent=Allied damage taken grants energy
AurielEnergizedCordRayOfHeavenTalent=Increases energy from Auriel Basic Attacks
AurielGlimmerofHopeRayOfHeavenTalent=Regen Globes reduce Ray of Heaven energy cost
AurielHeavyBurdenDetainmentStrikeTalent=Detainment Strike slows enemies after stun
AurielIncreasingClaritySacredSweepTalent=<c val="#TooltipQuest">Quest:</c> Increases center damage by hitting Heroes
AurielLightSpeedResurrectTalent=Resurrected allies gain Move Speed, reduce cooldown
AurielMajesticSpanSacredSweepTalent=Increases Sacred Sweep radius
AurielPiercingLashDetainmentStrikeTalent=Detainment Strike hits all enemy Heroes in a line
AurielRayOfHeaven=Spend all energy to heal allied Heroes in an area
AurielRepeatedOffenseDetainmentStrikeTalent=<c val="#TooltipQuest">Quest:</c> Increases damage when Heroes are stunned
AurielRepellingStrikeDetainmentStrikeTalent=Detainment Strike knocks enemies away farther
AurielReservoirofHopeRayOfHeavenTalent=<c val="#TooltipQuest">Quest:</c> Increases maximum Ray of Heaven energy
AurielResurrect=Bring an allied Hero back to life
AurielRibbonFlight=Pull yourself to a point beyond targetted ally
AurielRighteousAssaultSacredSweepTalent=Reduce Sacred Sweep cooldown by hitting Heroes
AurielSacredSweep=Damages enemies in an a wide arc, bonus damage to enemies in the center
AurielSearingLightRayOfHeavenTalent=Ray of Heaven also damages enemies in the area
AurielShieldOfHopeTalent=Shield nearby allies based on their missing Health
AurielSwiftSweepSacredSweepTalent=Increases Sacred Sweep cast speed
AurielWillofHeavenBestowHopeTalent=Bestow Hope ally gains Attack Speed
AurielWrathofHeavenBestowHopeTalent=Bestow Hope ally gains Spell Power
AurielCrystalAegis=Put an allied Hero into a Stasis crystal that explodes
AzmodanAllShallBurn=Channel a death beam on an enemy
AzmodanAllShallBurnGluttonyTalent=All Shall Burn heals Azmodan
AzmodanAllShallBurnMarchOfSinTalent=Increases All Shall Burn Movement Speed
AzmodanAllShallBurnMasterOfDestructionTalent=Reduces All Shall Burn Mana cost, increases Range
AzmodanBlackPool=Create an empowering zone
AzmodanBlackPoolFifthCircleTalent=Black Pool gives slowing attacks
AzmodanDemonicInvasion=Damage area and create an army of Grunts
AzmodanDemonicInvasionPerishingFlameTalent=Demonic Grunts explode on death
AzmodanGeneralOfHell=Azmodan summons a Demon Lieutenant to assist Minions, Mercenaries, and Summons
AzmodanGeneralOfHellBoundMinionTalent=General of Hell improves a Minion
AzmodanGeneralOfHellDemonicSmiteTalent=Demon Lieutenants cast Demonic Smite
AzmodanGeneralOfHellForcedRecruitmentTalent=Reduces General of Hell cooldown, gains a charge
AzmodanGlobOfAnnihilationBattlebornTalent=Globe of Annihilation summons a Demon Warrior
AzmodanGlobeOfAnnihilation=Launch a long range orb of destruction dealing area damage
AzmodanGlobeOfAnnihilationHedonismTalent=Reduces Globe of Annihilation Mana cost
AzmodanGlobeOfAnnihilationInfernalGlobeTalent=Reduces cast time and increases missile speed
AzmodanGlobeOfAnnihilationSiegingWrathTalent=<c val="#TooltipQuest">Quest:</c> Hitting Heroes empowers Globe of Annihilation
AzmodanGlobeOfAnnihilationTasteForBloodTalent=<c val="#TooltipQuest">Quest:</c> Kills increase Globe of Annihilation damage
AzmodanGlobeOfAnnihilationTasteforBloodQuestToken=<c val="#TooltipQuest">Quest:</c> Kills increase Globe of Annihilation damage
AzmodanGluttonousWardHotbar=Place a ward that restores Azmodan's Health and Mana
AzmodanHellishHirelings=General of Hell improves Mercenary damage
AzmodanInfusedPowerTalent=Increases All Shall Burn's damage
AzmodanSinforSin=Activate to steal Health from an enemy
AzmodanSinsGraspHotbar=Activate to deal damage over time
AzmodanSummonDemonWarrior=Summon a Demon Warrior
AzmodanSummonDemonWarriorArmyOfHellTalent=Demon Warriors deal more damage, cost less Mana
AzmodanSummonDemonWarriorHellforgedArmorTalent=Demon Warriors burn enemies and take less damage
BarbarianAncientSpear=Throw a spear and pull self to the first enemy hit, stunning and dealing damage
BarbarianAncientSpearCompositeSpearTalent=Increase Ancient Spear range, grants Armor
BarbarianAncientSpearMysticalSpearTalent=Ancient Spear always pulls, cooldown reduced
BarbarianAncientSpearPoisonedSpearTalent=Ancient Spear deals damage over time
BarbarianBattleRage=Increase damage to Mercenaries, activate to heal
BarbarianFury=Generate Fury in combat. All Abilities grant Move Speed
BarbarianFuryEndlessFuryTalent=Increases max Fury
BarbarianFuryFerociousHealing=Spend Fury to gain Health
BarbarianFuryNoEscapeTalent=Abilities give more Movement Speed
BarbarianFuryShotOfFuryTalent=Activate to gain Fury
BarbarianFuryWarPaintTalent=Basic Attacks heal
BarbarianGiantSlammer=Seismic Slam deals bonus damage
BarbarianHurricaneWhirlwindTalent=Whirlwind removes slows and roots
BarbarianIgnorePain=Activate to gain massive Armor
BarbarianLeap=Jump to a location, deal damage, and stun enemies
BarbarianLeapArreatCraterTalent=Leap creates a crater and has reduced cooldown
BarbarianNervesOfSteel=Activate to gain a Shield
BarbarianRampage=Basic Attacks reduce Ancient Spear cooldown
BarbarianRanseur=[PH] Ancient Spear always pulls, reduced Cooldown
BarbarianRuthless=Increase Whirlwind damage to low Health targets
BarbarianSeismicSlam=Damage an enemy and splash damage behind them
BarbarianSeismicSlamFuriousBlowTalent=Empower Seismic Slam
BarbarianSeismicSlamShatteredGroundTalent=Increase Seismic Slam splash damage
BarbarianStridingGiant=Wrath of the Berserker can grant Unstoppable
BarbarianStridingGiantActive=[PH] Increased health and activate to become unstoppable
BarbarianToughAsNails=Periodically gain Physical Armor
BarbarianWhirlwind=Damage nearby enemies and heal for a percentage of damage dealt
BarbarianWhirlwindLifeFunnelTalent=Increases Whirlwind healing
BarbarianWrathoftheBerserker=Increase damage and reduce disable duration
BrightwingArcaneBarrageTalent=Increase Arcane Flare range
BrightwingArcaneFlare=Deals damage in an area. Deals greater damage to targets in the center
BrightwingArcaneFlareArcanePrecisionTalent=Increases Arcane Flare inner damage
BrightwingArcaneFlareStickyFlareTalent=Arcane Flare slows enemies
BrightwingBlinkHealAllyDash=Teleport to allies and heal them
BrightwingBouncyDustTalent=Pixie Dust bounces
BrightwingDoubleWyrmholeTalent=Free Blink Heal on second target
BrightwingDreamShotTalent=Empowers Arcane Flare
BrightwingEmeraldWind=Damages and pushes enemies in area
BrightwingEmeraldWindContinuousWindsTalent=Emerald Wind gains two additional novas
BrightwingEmeraldWindSoothingMistAppender=Passively increases Soothing Mist healing
BrightwingGreaterPolymorphTalent=Increases Polymorph duration
BrightwingManicPixieTalent=Pixie Dust increases Soothing Mist healing
BrightwingMistifiedTalent=Basic Abilities reduce Soothing Mist cooldown
BrightwingPhaseShift=Teleport to an allied Hero
BrightwingPhaseShiftHyperShift=Soothing Mist reduces Phase Shift cooldown
BrightwingPhaseShiftPeekaboo=Empowers Phase Shift
BrightwingPhaseShiftPhaseShield=Grant Shields upon arrival
BrightwingPixieBoostTalent=Pixie Dust grants an additional burst of speed
BrightwingPixieDust=Increase an ally's movement speed and grant Spell Armor
BrightwingPixieDustShieldDustTalent=Pixie Dust grants Physical Armor
BrightwingPolymorph=Disable an enemy
BrightwingPolymorphCritterizeTalent=Polymorph lowers enemy's Armor
BrightwingRevitalizingMistTalent=Soothing Mist heals more subsequently
BrightwingSoothingMist=Brightwing passively heals nearby allied Heroes
BrightwingSoothingMistGustofHealing=Brightwing passively heals nearby allied Heroes
BrightwingUnfurlingSprayTalent=Increases Soothing Mist range
BrightwingUnstableAnomalyTalent=Polymorphed targets explode
ButcherButchersBrand=Brand an enemy, granting Life Steal against them
ButcherButchersBrandCraveFleshTalent=Butcher's Brand grants Move Speed
ButcherButchersBrandInsatiableBladeTalent=Increases Move Speed while enemies are branded
ButcherCleaver=Basic Attacks deal area damage
ButcherEnragedTalent=Gain Attack Speed and Armor at low Health
ButcherFreshBloodFrenzyMeatTalent=Basic Attacks grant Attack and Move Speed
ButcherFreshMeat=Gather strength by killing enemies and collecting their meat
ButcherFreshMeatAbattoirTalent=Lose less Meat on death
ButcherFreshMeatAbattoirToken=Gather strength by killing enemies and collecting their meat
ButcherFreshMeatToken=Upon dying, nearby enemy Minions drop <c val="#TooltipNumbers">1</c> Fresh Meat and enemy Heroes drop <c val="#TooltipNumbers">25</c> Fresh Meat. Fresh Meat can be picked up to gain <c val="#TooltipNumbers"><d ref="Accumulator,ButcherFreshMeatAccumulator,Scale"precision="2"/></c> Attack Damage per Meat. The Butcher loses <c val="#TooltipNumbers"><d ref="-Effect,ButcherFreshMeatDeathRemoveStacks,Value"/></c> Fresh Meat upon dying.<n/><n/><img path="@UI/StormTalentInTextQuestIcon" alignment="uppermiddle" color="B48E4C" width="20" height="22"/><c val="#TooltipQuest">Quest:</c> Collect <c val="#TooltipNumbers"><d ref="Behavior,ButcherFreshMeatTokenCounter,ConditionalEvents[0].CompareValue"/></c> Fresh Meat.<n/><n/><img path="@UI/StormTalentInTextQuestIcon" alignment="uppermiddle" color="B48E4C" width="20" height="22"/><c val="#TooltipQuest">Reward:</c> Gain an additional <c val="#TooltipNumbers"><d ref="Behavior,ButcherFreshMeatQuestCompletionCarry,Modification.DamageDealtScaled[Basic]"/></c> Attack Damage and <c val="#TooltipNumbers"><d ref="100*Behavior,ButcherFreshMeatQuestCompletionCarry,Modification.AdditiveAttackSpeedFactor"/>%</c> increased Attack Speed. Heroes continue to drop <c val="#TooltipNumbers"><d ref="Effect,ButcherFreshMeatQuestCompleteModifyHeroMeatCount,EffectArray[0].Value"/></c> Fresh Meat, Minions no longer drop Fresh Meat, and Fresh Meat is no longer lost on death.
ButcherFreshMeatVictualsTalent=Nearby Minion deaths heal
ButcherFurnaceBlast=Deal damage around The Butcher after a delay
ButcherFurnaceBlastFiresofHellTalent=Furnace Blast explodes twice
ButcherHamstring=Deals damage in an area and slows enemies
ButcherHamstringBrutalStrikeTalent=Hamstring empowers Basic Attacks
ButcherHamstringCheapShotTalent=Increase Hamstring damage to disabled targets
ButcherHamstringChopMeatTalent=Increases Hamstring damage to non-Heroes
ButcherHamstringCripplingSlamTalent=Hamstring slow no longer fades and lasts longer
ButcherHamstringFlailAxeTalent=Increases Hamstring length
ButcherHamstringInvigorationTalent=Reduces Hamstring Mana cost, cooldown
ButcherLambToTheSlaughter=Chain an enemy Hero to a post
ButcherLambToTheSlaughterSlaughterhouseTalent=Lamb to the Slaughter chains all enemy Heroes
ButcherMeatShield=Ruthless Onslaught grants Spell Armor
ButcherRuthlessOnslaught=Charges at an enemy, stunning and dealing damage
ButcherRuthlessOnslaughtSavageChargeTalent=Ruthless Onslaught deals extra damage
ButcherRuthlessOnslaughtUnrelentingPursuitTalent=Reduces Ruthless Onslaught cooldown on impact
ChenAccumulatingFlame=<c val="#TooltipQuest">Quest:</c> Ignite Heroes to empower Breath of Fire
ChenAccumulatingFlameToken=<c val="#TooltipQuest">Quest:</c> Hit Heroes to empower Breath of Fire
ChenAnotherRound=Keg Smash lowers cooldowns, has increased radius
ChenBreathOfFire=Breathe fire in target direction, dealing damage and igniting Brew-soaked enemies
ChenBreathOfFireRingOfFireTalent=Damage nearby enemies after using Breath of Fire
ChenEarth=None
ChenElusiveBrawler=Activate to evade Basic Attacks
ChenElusiveBrawlerHotbar=Activate to evade all Basic Attacks
ChenFire=Increase Attack Speed
ChenFirePassive=Increase Attack Speed
ChenFlyingKick=Kick through target enemy
ChenFlyingKickDeadlyStrikeTalent=Increase Flying Kick damage and remove Brew cost
ChenFlyingKickPressurePointTalent=Flying Kick slows enemies
ChenFlyingLeap=Increased Range
ChenFortifyingBrew=Drink Brew, gaining a Shield while drinking. Chen's Abilities cost Brew instead of Mana.
ChenFortifyingBrewBolderFlavorTalent=Fortifying Brew grants a large Shield immediately
ChenFortifyingBrewBrewmastersBalanceTalent=Gain bonuses based on current level of Brew
ChenFortifyingBrewEnoughToShareTalent=Fortifying Brew Shields allied Heroes
ChenFortifyingBrewGroundingBrewTalent=Fortifying Brew grants Spell Armor
ChenFreshestIngredients=<c val="#TooltipQuest">Quest:</c> Regen Globes increase Health Regen
ChenFreshestIngredientsTalentToken=<c val="#TooltipQuest">Quest:</c> Regen Globes increase Health Regen
ChenKegSmash=Drench enemies in a nearby area with Brew, slowing them
ChenKegSmashATouchOfHoneyTalent=Increase Keg Smash slow
ChenKegSmashKegTossTalent=<c val="#TooltipQuest">Quest:</c> Hit Heroes to empower Keg Smash
ChenKegTossToken=<c val="#TooltipQuest">Quest:</c> Hit Heroes to empower Keg Smash
ChenPurifyingBrew=Fortifying Brew reduces crowd control
ChenRefreshingElixir=Healing effects greatly increased while drinking
ChenStorm=Increase Movement Speed
ChenStormEarthFire=Split into three elemental spirits
ChenStormEarthFireElementalConduitTalent=Increase spirit Health and empower their abilities
ChenStormstoutSecretRecipe=Basic Abilities heal Chen
ChenWanderingKeg=Roll around in the barrel and knock away enemies
ChenWanderingKegUntappedPotentialTalent=Increases Wandering Keg Speed, Armor
ChenWitheringFlames=Setting Heroes on fire reduces their Spell Power
ChoCallousedHide=Ogre Hide increases healing received
ChoConsumingBlaze=Damage nearby enemies and heal Cho
ChoConsumingFire=Increased healing against Heroes
ChoCthunsGiftTalent=Basic Attacks are now ranged, slow targets
ChoEnragedRegeneration=Gall's Ogre Rage increases Health Regen
ChoFavorOfTheOldGodsTalent=Upheaval roots Heroes
ChoFirestarter=Reduced Consuming Blaze cooldown
ChoFrenziedFistsTalent=Surging Fist increases Attack Speed
ChoFuelForTheFlameTalent=<c val="#TooltipQuest">Quest</c>: Kills empower Consuming Blaze
ChoFuelForTheFlameToken=Minion and Hero kills empower Consuming Blaze
ChoHammerOfTwilight=Activate to knockback and Stun enemies
ChoHourofTwilight=Reduced death timer
ChoOgreHideActivated=Activate to increase Armor
ChoOgreHidePassive=Increased Armor
ChoPowerSurgeTalent=Surging Fist cooldown lowers against Heroes
ChoRollbackTalent=Rune Bomb returns
ChoRuneBomb=Throw a Rune Bomb down a line. Gall can detonate it to do area damage
ChoRunedGauntletTalent=Basic Attacks reduce Heroic cooldowns
ChoRunicFeedbackTalent=Runic Blast reduces Rune Bomb cooldown
ChoSearedFleshTalent=Consecutive Basic Attacks deal bonus damage
ChoSurgingDashTalent=Unstoppable while channeling Surging Fist
ChoSurgingFist=Dash a direction knocking aside enemies
ChoTalentMoltenBlock=Activate to become Invulnerable
ChoTheWillofCho=Takedowns increase Ogre Hide's Armor
ChoTheWillofChoToken=Takedowns increase Ogre Hide Armor
ChoTwilightVeilTalent=Activate to increase Ogre Hide Armor
ChoTwoHeaded=You have a second head named Gall
ChoUpheaval=Pull enemies in a large area
ChoUppercut=Increases Surging Fist damage
ChromieBronzeTalons=Increase Basic Attack range and damage
ChromieDragon'sClaw=Increased Attack range, Empower Basic Attacks
ChromieDragonsBreath=Deal damage in an area
ChromieDragonsBreathDeepBreathing=<c val="#TooltipQuest">Quest:</c> Hitting Heroes empowers Dragon's Breath
ChromieDragonsBreathDragonsEye=Increase Dragon’s Breath center damage
ChromieDragonsBreathEnvelopingAssault=Increase the radius of Dragon’s Breath
ChromieDragonsBreathMobiusLoop=Reduce Dragon’s Breath Mana, cooldown, damage
ChromieHereAndThere=Activate to swap positions with Sand Blast Echo
ChromiePortBackToBaseByeBye=Reduce Hearthstone cast time
ChromieQuantumOverdrive=Activate to gain Spell Power
ChromieReachingThroughTime=Increases Sand Blast and Dragon’s Breath range
ChromieSandBlast=Fire a long range blast that damages an enemy
ChromieSandBlastFastForward=Long range Sand Blasts reduce its cooldown
ChromieSandBlastMountingSand=Increase Sand Blast consecutive bonus
ChromieSandBlastPiercingSands=Sand Blast pierces
ChromieSandBlastShiftingSands=Sand Blast grants Spell Power
ChromieSlowingSands=Create a Slowing area
ChromieSlowingSandsPocketOfTime=Remove Slowing Sands Mana cost, increase Slow
ChromieTemporalLoop=Return an enemy Hero to a previous position
ChromieTemporalLoopStuckInALoop=Temporal Loop teleports twice
ChromieTimeOutCancel=Cancel Time Out.
ChromieTimeOutHotbar=Activate to become Invulnerable
ChromieTimeTrap=Place a trap that Time Stops enemies
ChromieTimeTrapAndorhalAnomaly=Increase Time Trap charges
ChromieTimeTrapChronoSickness=Reduce Time Trap cooldown, Mana cost, adds Slow
ChromieTimeTrapTimelySurprise=Time Trap resets Basic Abilities
ChromieTimewalkerTrait=Gain Talents earlier than everyone else
ChromieTimewalkersPursuit=Activate to reveal an area<n/><c val="#TooltipQuest">Quest:</c> Regen Globes increase Mana Regen
ChromieTimewalkersPursuitActive=Activate to reveal an area<n/><c val="#TooltipQuest">Quest:</c> Regen Globes increase Mana Regen
CrusaderBlessedShield=Throw a bouncing shield that Stuns
CrusaderBlessedShieldRadiatingFaithTalent=Increase Blessed Shield Stun duration, max targets
CrusaderBlindedByTheLight=Activate to Shield nearby allies
CrusaderCondemn=Pulls and damages nearby enemies
CrusaderCondemnBlessedHammerTalent=Activate to create spinning hammers
CrusaderCondemnConvictionTalent=Condemn increases Movement Speed
CrusaderCondemnKnightTakesPawnTalent=Increases Condemn effect versus Minions and Mercenaries
CrusaderEternalRetaliationTalent=Condemn cooldown reduced per enemy hit
CrusaderFallingSword=Jump to area, damaging and Slowing enemies
CrusaderFallingSwordHeavensFuryTalent=Falling Sword bombards enemies with holy bolts
CrusaderHolyFury=Deals damage to nearby enemies
CrusaderIndestructableTalent=Gain a Shield instead of dying
CrusaderIronSkin=Becomes Unstoppable and gains a Shield
CrusaderIronSkinFanaticismTalent=Damage taken during Iron Skin grants Move Speed
CrusaderIronSkinHoldYourGroundTalent=Increases Iron Skin Shield, reduced cooldown
CrusaderIronSkinReinforceTalent=Basic Abilities grant Physical Armor
CrusaderIronSkinTheCrusadeMarchesOnTalent=Abilities reduce the cooldown of Iron Skin
CrusaderLawsOfHope=Increases Health Regen, activate to burst heal
CrusaderPunish=Damage and slow enemies
CrusaderPunishRighteousSmashTalent=Punish restores Mana per enemy hit
CrusaderRoarTalent=Increase Punish damage
CrusaderShieldGlare=Damages and blinds enemies in a cone
CrusaderShieldGlareHolyRenewalTalent=Shield Glare heals for each Hero hit
CrusaderShieldGlareSinsExposedTalent=Shield Glare makes enemies take bonus damage
CrusaderSubdueTalent=<c val="#TooltipQuest">Quest:</c> Increase Punish Slow
CrusaderZealousGlare=Increase Shield Glare duration
DeckardAncientBlessings=Activate Fortitude to empower ally Attacks
DeckardBottomlessFlask=Healing Potions recharge after use
DeckardCubeMastery=Horadric Cube reduces Scroll of Sealing cooldown
DeckardFieldStudy=Scroll of Sealing can grant Spell Power
DeckardFortitudeOfTheFaithful=Nearby allies grant Armor, cooldown reduction
DeckardGemEmerald=Next Horadric Cube reduces enemy healing received
DeckardGemRuby=Next Horadric Cube creates Lesser Healing Potions
DeckardGemSapphire=Next Horadric Cube Slow increased
DeckardHealingPotion=Throw Potions that heal allies
DeckardHoradricCubeCharging=Damage and Slow enemies in an area
DeckardHoradricStaff=Basic Attacks periodically Stun Heroes
DeckardKanaisCube=Horadric Cube reduces Hero damage dealt
DeckardLorenado=Conjure a lorenado that knocks enemies away
DeckardMorenados=Hitting Heroes reduces Lorenado cooldown
DeckardPerfectGems=Reduce Gem, Horadric Cube cooldown
DeckardPotionOfRevival=Healing Potions heal in an area
DeckardPotionOfShielding=Healing Potions grant a Shield
DeckardRejuvenationPotion=Healing Potions restore Mana, heal more
DeckardRespectTheElderly=Stay Awhile and Listen Silences, Blinds
DeckardSafetyInNumbers=Additional allies empower Fortitude of the Faithful
DeckardScrollOfIdentify=<c val="#TooltipQuest">Quest:</c> Scroll of Sealing reveals, reduces Armor
DeckardScrollOfSealing=Damage and Root enemies in an area
DeckardScrollOfStoneCurse=Scroll of Sealing can deal more damage
DeckardStayAWhileAndListen=Put enemies to Sleep with a fascinating story
DeckardSuperHealingPotion=Healing Potions heal more after a duration
DehakaAdaptation=Heal back damage taken
DehakaAdaptationChangeIsSurvivalTalent=Enhanced Adaptation healing, cooldown
DehakaBrushstalker=Burrow to a bush on the Battleground.
DehakaBrushstalkerApexPredatorTalent=Reduced Brushstalker cooldown, cast time
DehakaBrushstalkerFerociousStalkerTalent=Brushstalker increases Dark Swarm damage
DehakaBurrow=Gain Stasis by burrowing into the ground
DehakaBurrowImprovedBurrowTalent2=While Burrowed you can move
DehakaBurrowTalentLurkerStrain=Burrow Stealths, knocks enemies away
DehakaCancelBurrow=Unburrow
DehakaDarkSwarm=Damage nearby enemies
DehakaDarkSwarmTalentEnduringSwarm=Dark Swarm grants Spell Armor
DehakaDarkSwarmTalentPrimalAggression=Increases Dark Swarm damage to Minions, Mercs
DehakaDarkSwarmTalentSymbiosis=Reduces Dark Swarm cooldown against Heroes
DehakaDrag=Deal light damage and drag an enemy
DehakaDragTalentConstriction=Increases Drag duration
DehakaDragTalentElongatedTongue=Increases Drag range
DehakaDragTalentFeedingFrenzy=Basic Attacks reduce Drag cooldown
DehakaDragTalentParalyzingEnzymes=Drag slows
DehakaEssenceClaws=Basic Attacks slow, grant Essence
DehakaEssenceCollection=Collect and consume enemy Essence to heal
DehakaEssenceCollectionOneWhoCollectsTalent=Increases Essence from Minions
DehakaEssenceCollectionStore=Killing enemy Heroes or Minions stores Essence that will heal over time when activated
DehakaEssenceCollectionTalentEnhancedAgility=<c val="#TooltipQuest">Quest:</c> Essence increases Brushstalker Move Speed
DehakaEssenceCollectionTalentEssenceDevourer=<c val="#TooltipQuest">Quest:</c> Regen Globes increase max Essence
DehakaEssenceCollectionTalentHeroStalker=Takedowns grant more Essence
DehakaEssenceCollectionTalentTissueRegeneration=<c val="#TooltipQuest">Quest:</c> Essence increases Health Regen, max Essence
DehakaIsolation=Silence, Slow, and reduce vision of an enemy
DehakaIsolationTalentContagion=Isolation splashes to nearby Heroes
DehakaPrimalRage=Essence increases Attack Damage
DehakaPrimalSwarm=Dark Swarm lowers enemies' Armor
DehakaSwiftPursuit=Increases Brushstalker bush move bonus duration
DehakaTunnelingClaws=Dehaka can move while Burrowed
DemonHunterCreedoftheHunter=Increases Attack Speed<n/><c val="#TooltipQuest">Quest:</c> Attacking Heroes empowers Hatred
DemonHunterDeathDealer=Increases Vault Basic Attack damage bonus
DemonHunterFarflightQuiver=Increases Basic Attack range
DemonHunterGloom=Consume Hatred to gain Spell Armor
DemonHunterGloomItem=Consume Hatred to gain Spell Armor
DemonHunterHatred=Basic Attacks grant bonus Attack Damage and Move Speed temporarily
DemonHunterHatredHotPursuitTalent=Max Hatred increases Movement Speed and Mana Regen
DemonHunterHatredPunishmentTalent=Hatred increases Multishot damage
DemonHunterHatredRancorTalent=Hatred increases Attack Speed
DemonHunterHatredTemperedByDisciplineTalent=Max Hatred grants healing on Basic Attacks
DemonHunterHungeringArrow=Fire an arrow which seeks out and strikes multiple targets
DemonHunterHungeringArrowMonsterHunterTalent=Reduces Hungering Arrow Mana cost and increases non-Hero damage
DemonHunterHungeringArrowPuncturingArrowTalent=<c val="#TooltipQuest">Quest:</c> Hitting Heroes empowers Hungering Arrow
DemonHunterHungeringArrowSiphoningArrowTalent=Hungering Arrow returns damage as Health
DemonHunterManticore=Consecutive Basic Attacks against Heroes are empowered
DemonHunterMultishot=Damage enemies in an area
DemonHunterMultishotArsenalTalent=Multishot launches grenades
DemonHunterMultishotCompositeArrowsTalent=Increases range of Multishot
DemonHunterMultishotFrostShotTalent=Multishot slows enemies and has increased range
DemonHunterRainOfVengeance=Area attack that stuns enemies
DemonHunterRainOfVengeanceStormOfVengeanceTalent=Basic Attacks reduce Cooldown
DemonHunterSeethingHatred=Hatred stacks faster and lasts longer
DemonHunterStrafe=Unleashes a flurry of arrows at enemies
DemonHunterStrafeDeathSiphonTalent=Fires penetrating bolts and heals
DemonHunterVault=Dash to a location
DemonHunterVaultCaltropsTalent=Drop Caltrops while Vaulting <n/><c val="#TooltipQuest">Quest:</c> Maintain Hatred to empower Vault
DemonHunterVaultRepeatingArrowTalent=Vault refreshes Hungering Arrow
DemonHunterVaultTumbleTalent=Hold two charges of Vault
DiabloApocalypse=Stun all enemy Heroes
DiabloApocalypseDyingBreathTalent=Apocalypse triggers on death
DiabloBlackSoulstone=Gather souls from enemies to gain Health and resurrect faster
DiabloBlackSoulstoneDevilsDueTalent=Souls empower Regen Globes, Healing Fountains
DiabloBlackSoulstoneSoulFeastTalent=Black Soulstone increases Health Regen
DiabloBlackSoulstoneToken=Max Health Bonus: <c val="#TooltipNumbers"><d ref="100*($BehaviorStackCount:DiabloBlackSoulstoneTokenCounter$*Accumulator,DiabloBlackSoulstoneHealthAccumulator,Scale)"precision="2"/>%</c>
DiabloBulwark=Increases Shadow Charge Armor duration
DiabloDebilitatingFlames=Fire Stomp slows enemy Heroes
DiabloDevastatingCharge=<img path="@UI/StormTalentInTextQuestIcon" alignment="uppermiddle" color="B48E4C" width="20" height="22"/><c val="#TooltipQuest">Quest:</c> Increase Shadow Charge damage
DiabloDiabolicalMomentum=Basic Attacks reduce Ability cooldowns
DiabloFearfulPresence=Activate to reduce enemy damage
DiabloFearfulPresenceTalent=Activate to reduce enemy damage
DiabloFireStomp=Unleash fire waves in all directions
DiabloFirestompFireDevilTalent=Fire Stomp grants a damage aura
DiabloHellfire=Increases Fire Stomp damage
DiabloHellgateTalent=Teleport and create an Apocalypse
DiabloLifeLeechTalent=Basic Attacks against Heroes heal
DiabloLightningBreath=Channeled spell that damages enemies
DiabloLightningBreathHellstormTalent=Lightning Breath lasts and reaches longer
DiabloLordOfTerror=Steal Health from nearby enemy Heroes
DiabloOverpower=Grab an enemy and slam them behind Diablo, stunning them and dealing damage
DiabloOverpowerDemonicStrengthTalent=Overpower also slows
DiabloOverpowerDominationTalent=Overpower resets cooldown of Shadow Charge
DiabloShadowCharge=Charge to a target enemy and push them back
DiabloShadowChargeFromTheShadowsTalent=Increases Shadow Charge range
DiabloSoulShield=Black Soulstone grants Spell Armor
DiabloSpeedDemon=Being Stunned, Rooted grants Movement Speed
DragonKnightBullRush=Deal damage to enemies and send them flying
DragonKnightFireBreath=Deals initial damage and burns the ground for a time
DryadAbolishMagicHotbar=Remove negative status effects from Lunara and the target
DryadBlossomSwellTalent=Increases Noxious Blossom radius
DryadBoundlessStrideTalent=All Leaping Strike charges returned at once, can target allies
DryadChokingPollenTalent=Increases Noxious Blossom damage to enemies with Nature's Toxin
DryadCripplingSpores=Slow enemies afflicted by Nature's Toxin and extend duration
DryadCruelSporesTalent=Reduces Crippling Spores cooldown and Mana on Minions and Mercs
DryadDividingWispTalent=Relocating a Wisp creates a copy
DryadDryadsSwiftness=Lunara moves about <c val="#TooltipNumbers">20%</c> faster by leaping short distances.
DryadForestsWrathTalent=Increases Thornwood Vine range and speed
DryadGallopingGaitTalent=Activate to increase Movement Speed
DryadGreaterSpellShieldItemDisabled=Greatly reduces incoming Ability Damage
DryadGreaterSpellShieldItemEnabled=Greatly reduces incoming Ability Damage
DryadGreaterSpellShieldTalent=Periodically gain temporary Spell Armor
DryadInvigoratingSporesTalent=Crippling Spores increases Basic Attack Speed
DryadLeapingStrike=Damages and leaps over an enemy
DryadLetThemWitherTalent=Increases Crippling Spores slow
DryadNaturalPerspectiveTalent=Nature's Toxin reveals enemies
DryadNaturesCullingTalent=Increases Nature's Toxin damage to non-Heroes
DryadNaturesToxin=Basic Attacks and damaging Abilities deal damage over time
DryadNimbleWispTalent=Increases Wisp Move Speed and vision
DryadNoxiousBlossom=Deals area damage
DryadPesteringBlossomTalent=Increases Noxious Blossom range
DryadPhotosynthesisTalent=Crippling Spores returns Mana
DryadSiphoningToxinTalent=Nature's Toxin heals Lunara
DryadSkyboundWispTalent=Wisp sees over obstacles and reveals area on death
DryadSplinteredSpearTalent=Noxious Blossom causes Basic Attack to hit 4 targets
DryadStarWoodSpearTalent=Crippling Spores increases Basic Attack range
DryadThornwoodVine=Damages in a line
DryadTimelostWispTalent=Wisp costs no Mana and reduces cooldown
DryadUnfairAdvantageTalent=Increases Nature's Toxin damage to slowed Heroes
DryadWildVigorTalent=Crippling Spores increases Basic Attack damage
DryadWisp=Spawns a Wisp to scout
DVaBigShotPewPewPew=Big Shot fires multiple pulses
DVaBoostersComingThrough=Increase Boosters knockback
DVaBoostersCrashCourse=<c val="#TooltipQuest">Quest:</c> Reduce Boosters cooldown
DVaBoostersHitTheNitrous=Boosters give extra immediate speed
DVaBoostersRushdown=Reduced Boosters cooldown if used out of combat
DVaBunnyHopOn=Become Unstoppable and Slow nearby Heroes
DVaBunnyHopStopAndPop=Bunny Hop damage increased if stationary
DVaPilotCallMech=None
DVaDefenseMatrixAggressionMatrix=Basic Attacks lower Defense Matrix cooldown
DVaDefenseMatrixDazerZone=Defense Matrix Slows
DVaDefenseMatrixDivertingPower=Increase Defense Matrix size, Move Speed reduced
DVaDefenseMatrixFusionGenerator=Defense Matrix adds Self-Destruct Charge
DVaDefenseMatrixGetThroughThis=Increase Defense Matrix duration
DVaMechAblativeArmor=Take less damage from weak attacks
DVaMechBoosters=Move fast and knockback enemies
DVaMechDefenseMatrix=Reduce damage of enemy Heroes in an area
DVaMechDefenseMatrixFace=Reduce damage of enemy Heroes in an area
DVaMechEmergencyShielding=Mech gains a Shield instead of dying
DVaMechExpensivePlating=Increase Mech Health and Call Mech cooldown
DVaMechMEKAout=While in her Mech, D.Va can shoot while moving, but her Movement Speed is reduced.
DVaMechMechMode=D.Va can eject from her Mech and continue to fight
DVaMechProMoves=Taking damage increases Move Speed
DVaMechSelfDestruct=Eject from the Mech, setting it to self-destruct for massive damage
DVaPilotBigShot=Damage enemies in a line as a Pilot
DVaPilotCallMechMEKAfall=Load instantly, targetable, adds damage.
DVaPilotCallMechMEKAfallTalent=Call Mech is instant and targetable, damages enemies
DVaPilotConcussivePulseAbility=Damage and knockback nearby enemies
DVaPilotConcussivePulseTalent=Knockback enemies as a Pilot
DVaPilotGGWP=Increased Pilot damage, Takedowns refresh Mech
DVaPilotNanoweaveSuit=Faster Call Mech, ejection grants Armor
DVaPilotPilotMode=None
DVaPilotSuppressingFire=Pilot Basic Attacks Slow, range increased
DVaPilotTorpedoDashAbility=Dash towards target location
DVaPilotTorpedoDashTalent=Dash as a Pilot
DVaSelfDestructBringItOn=Increase Self-Destruct Charge rate
DVaSelfDestructNuclearOption=Increase Self-Destruct timer and damage
ETCBlockParty=Rockstar grants allies Physical Armor
ETCBlockPartyToken=Rockstar also grants Block
ETCCrowdSurfer=Powerslide can go over terrain
ETCEncoreTalent=Face Melt will knock enemies away a second time
ETCGuitarSoloAggressiveShreddingTalent=Basic Attacks reduce Guitar Solo cooldown
ETCHammeronTalent=Abilities increase Basic Attack damage
ETCJustKeepRockinTalent=Guitar Solo reduces disable durations
ETCMicCheckTalent=Reduces Face Melt cooldown when hitting multiple enemies
ETCPinballWizardTalent=Increases Face Melt damage after Powerslide
ETCProgRockTalent=<c val="#TooltipQuest">Quest:</c> Regen Globes empower Guitar Solo
ETCRollingLikeaStoneTalent=Increased range on Powerslide
ETCShowStopperTalent=Powerslide gives Armor
ETCSpeedMetalTalent=Move Speed is added to Rockstar 
ETCStageDiveCrowdPleaserTalent=Stage Dive impact area bigger, cooldown reduced
FaerieDragonPixieCharm=Heal Allies with Soothing Mist to bribe a Mercenary
FaerieDragonPixieCharmTalent=Heal Allies with Soothing Mist to bribe a Mercenary
FaerieDragonPixieCharmTalentToken=Heal Allies with Soothing Mist to bribe a Mercenary
FaerieDragonPixieCharmToken=Heal Allies with Soothing Mist to bribe a Mercenary
FalstadBarrelRoll=Dash to a location and gain a temporary shield
FalstadBarrelRollAfterburnerTalent=Barrel Roll increases Move Speed
FalstadBarrelRollUpdraftTalent=Increases Barrel Roll range and Shield
FalstadChargedUpTalent=Increases Lightning Rod strikes and range
FalstadEpicMountTalent=Reduces Flight cooldown and delay
FalstadFlight=Instead of mounting, Falstad can fly a great distance over terrain
FalstadFlowRiderTalent=Tailwind recharges Basic Abilities faster
FalstadFreeRollTalent=Barrel Roll costs no Mana
FalstadGatheringStormTalent=<c val="#TooltipQuest">Quest:</c> Hitting Heroes empowers Hammerang
FalstadHammerGainsTalent=Basic Attacks heal
FalstadHammerang=Throw out a Hammer that returns. Hammer slows and damages enemies
FalstadHammerangBOOMerangActive=Deal damage in a small area around the Hammer.
FalstadHammerangBOOMerangTalent=Activate Hammerang second time for more damage
FalstadHammerangCripplingHammerTalent=Increases Hammerang slow
FalstadHinterlandBlast=Long range damage beam
FalstadHinterlandBlastCalloftheWildhammerTalent=Increases Hinterland Blast range and damage
FalstadLightningRod=Deal damage to target enemy while staying close to them
FalstadMightyGust=Push away enemies and slow them
FalstadPowerThrowTalent=Hammerang travels farther and slows longer
FalstadSecretWeaponTalent=Increases Hammerang range, Basic Attack damage
FalstadStaticShieldTalent=Gain Shields after every Lightning Rod strike
FalstadTailwind=After not taking damage for a brief period, gain increased Movement Speed
FalstadTailwindAerieGustsTalent=Reduce Tailwind delay, increase Move Speed
FalstadThunderstrikesTalent=Lightning Rod deals increasing damage
FalstadWindTunnelTalent=Mighty Gust constantly knocks back
FalstadWingmanHotbar=Kill Minions to bribe a Mercenary and empower Lightning Rod
FalstadWingmanHotbarTalent=Kill Minions to bribe Mercenaries
FalstadWingmanTalentToken=Kill Minions to bribe a Mercenary and empower Lightning Rod
FalstadWingmanToken=Kill Minions to bribe a Mercenary and empower Lightning Rod
FenixAdaniumShell=Warp grants Armor
FenixAdvancedTargeting=<c val="#TooltipQuest">Quest:</c> Plasma Cutter circles an additional time
FenixArsenalOvercharge=Basic Attacks reduce Ability cooldowns
FenixArsenalSynergy=Repeater Cannon empowers Phase Bomb
FenixAuxiliaryShields=Basic Attacks grant Shields
FenixCombatAdvantage=Plasma Cutter deals more damage to Slowed targets
FenixDampeningField=Shield Capacitor grants Spell Armor
FenixDivertPowerWeapons=Activate to lose Shield, increase damage
FenixEmergencyProtocol=Gain Move Speed when Shield depletes
FenixInhibitingEnergy=Phase Bomb can Slow enemies hit
FenixMobileOffense=Movement empowers Basic Attacks
FenixOffensiveCadence=Successive Repeater Cannon attacks empowered
FenixPhaseBomb=Basic Attack speed increased
FenixPhotonicWeaponry=Shield Capacitor increases damage dealt
FenixPlanetCracker=Fire a laser across the battleground
FenixPlasmaCutter=Summon a laser that circles Fenix, damaging and Slowing enemies
FenixPurificationSalvo=Fire a barrage of homing missiles
FenixRapidRecharge=Healing regenerates Shield Capacitor
FenixRepeaterCannon=Basic Attacks splash, deal more damage, have longer range
FenixSecondaryFire=Plasma Cutter can fire Purification Salvo missiles
FenixShieldCapacitor=Permanent Shield that regenerates out of combat
FenixSingularityCharge=Increase Weapon Mode bonuses
FenixTargetAcquired=Repeater Cannon can grant Move Speed
FenixUnconqueredSpirit=Fatal damage recharges Shield Capacitor
FenixWarp=Warp to a location
FenixWarpConduit=Takedowns reset Warp cooldown
FenixWarpWarfare=Warp grants Attack Speed
FenixWeaponModes=Switch between Weapon Modes
FirebatActiveJuggernautPlating=Gain Spell Armor, then Shield for damage taken
FirebatAdrenalineStimpack=Activate to gain Attack Speed, Move Speed
FirebatBasicAttackBurnNotice=Your Basic Attacks slow and apply a stacking DoT.
FirebatBunkerDrop=Call down a Bunker
FirebatBunkerDropExitBunker=
FirebatBunkerDropFlamethrower=Deal damage to enemies in a line.
FirebatBunkerDropFortifiedBunker=Allies can cast Oil Spill from Bunker Drop
FirebatBunkerDropFortifiedBunkerOilSpill=
FirebatCombustion=Channel to damage and Slow enemies
FirebatCombustionCancel=
FirebatCombustionFlashFire=Combustion Slows, remove Move Speed penalty
FirebatEnduranceStimpack=Activate to gain a Shield
FirebatFlameStream=Fire two streams of flames
FirebatFlameStreamCrossfire=Flame Stream can deal bonus damage
FirebatFlameStreamFeedingtheFlame=Flame Stream can reduce Oil Spill cooldown
FirebatFlameStreamSuppressiveFire=Flame Stream reduces Spell Power
FirebatIgnite=Gain Armor and damage nearby enemies
FirebatIgniteHeatTreatment=Pyromania heals for damage dealt
FirebatIgniteMeltdown=Pyromania reduces enemy damage dealt
FirebatIncinerator=[PH] Channel two cones of fire that damages and slows enemy Attack Speed
FirebatJetPropulsion=Charge forward, Stunning and damaging enemy Heroes
FirebatJetPropulsionFuelLeak=Jet Propulsion creates a trail of Oil Spills
FirebatJetPropulsionThermalProtection=Jet Propulsion hits grant Armor, reduce cooldown
FirebatNeuralStimpack=Activate to increase cooldown recharge rate
FirebatNewHabits=<c val="#TooltipQuest">Quest:</c> Pyromania grants Unstoppable
FirebatOilSpill=Splash oil that Slows and can be Ignited to damage enemies and heal Blaze
FirebatOilSpillAdhesivePetroleum=Oil Spill Slows when Ignited
FirebatOilSpillGrillandKill=<c val="#TooltipQuest">Quest</c>: Increase Ignited Oil Spill damage, duration
FirebatOilSpillNanomachineCoating=Oil Spill reduces Attack Speed
FirebatOilSpillOilDispersal=Increase Oil Spill area, Slow
FirebatWeaponBurnNotice=Basic Attacks Slow, damage over time
FirebatWeaponIncineratorGauntlets=Basic Attacks Ignite Oil Spills, area increased
FuryoftheStormTalent=Basic Attacks chain to non-Heroes
GallBombsAwayTalent=<c val="#TooltipQuest">Quest: </c>Empower Runic Blast
GallDeafeningBlast=Runic Blast silences
GallDoubleBackAbility=Activate to reverse Dread Orb third bounce
GallDoubleBackTalent=Re-activate Dread Orb to reverse third bounce
GallDoubleTroubleTalent=<c val="#TooltipQuest">Quest: </c>Lower Shadowflame's cooldown
GallDoubleTroubleToken=Shadowflame cooldown reduced against burning Heroes
GallDreadOrb=Lob a ball of energy that bounces three times, damaging enemies it hits
GallEdgeOfMadnessTalent=Increase Shadowflame damage
GallEyeofKilroggHotbar=Place an eye that grants vision
GallKeepMoving=Increased Shove Movespeed duration
GallLeadenOrb=Dread Orb stuns
GallOgreRageActivated=Activate to increase Gall's Damage
GallOgreRagePassive=Increase Gall's Damage
GallOgreRampage=Cho's Ogre Hide reduces cooldowns
GallPsychoticBreakTalent=Cast Abilities after death
GallRisingDreadTalent=Increase Dread Orb area and damage
GallRunicBlast=Detonate Cho's Rune Bomb, dealing area damage
GallRunicPersistenceTalent=Runic Blast deals additional damage over time
GallSearingShadows=Increased Shadowflame Hero damage
GallShadowboltVolley=Launch a barrage of Shadow Bolts
GallShadowboltVolleyShadowfuryTalent=Shadow Bolt Volley pierces
GallShadowflame=Blast enemies in a narrow line
GallShadowsnare=Shadowflame slows Heroes
GallShiftingNether=Teleport and cast Twisting Nether
GallShoveHotbar=Nudge Cho a short distance
GallTaskmaster=Reduce Shove's cooldown
GallTheWillofGall=Takedowns increase Ogre Rage's Damage Bonus
GallTwilightNovaTalent=Dread Orb launches 2 extra bombs
GallTwistingNether=Slow and damage nearby enemies
GallTwoHeaded=Your head is attached to Cho
GallWeSeeYou=Lower Eye of Kilrogg cooldown
GarroshArmorUp=Gain Armor as Health gets lower
GarroshArmorUpActivatable=Activate Armor Up to increase bonus
GarroshArmorUpBodyCheck=Damage and Slow an enemy
GarroshArmorUpDoubleUp=Activate Armor Up to increase bonus
GarroshArmorUpInnerRage=Body Check gains an additional charge
GarroshBloodthirst=Deal damage and heal for a portion of missing Health
GarroshBloodthirstBloodcraze=Bloodthirst heals over time
GarroshBloodthirstInFortheKill=Bloodthirst kills reset cooldown, restore Mana
GarroshBloodthirstThirstforBattle=Basic Attacks reduce Bloodthirst cooldown
GarroshBodyCheckBruteForce=Body Check reduces healing received
GarroshDecimate=Damage and Slow nearby enemies
GarroshDecimateDeadlyCalm=Decimate reduces damage dealt
GarroshGroundbreaker=Deal damage to enemies, can Stun them
GarroshGroundbreakerDefensiveMeasures=Groundbreaker Stun grants Shield
GarroshGroundbreakerIntimidation=Groundbreaker reduces Attack Speed
GarroshGroundbreakerMortalCombo=Reduce Wrecking Ball cooldown on Stunned targets
GarroshGroundbreakerRoughLanding=Increase Groundbreaker Slow
GarroshGroundbreakerWarbreaker=<c val="#TooltipQuest">Quest:</c> Stun Heroes to empower Groundbreaker
GarroshHellscream'sWarsongDeathWish=Increases the duration and reduces the cooldown if an enemy is killed while Taunted
GarroshIndomitable=Activate to become Unstoppable
GarroshOppressor=Basic Attacks reduce Spell Power
GarroshWarlordsChallenge=Force nearby Heroes to attack Garrosh
GarroshWarlordsChallengeDeathWish=Takedowns reduce Warlord's Challenge cooldown
GarroshWreckingBall=Throw an enemy, damaging and Slowing them
GarroshWreckingBallEarthshaker=Wrecking Ball Stuns enemies near impact
GarroshWreckingBallIntotheFray=Activate to throw an ally
GarroshWreckingBallTitanicMight=Wrecking Ball throws an additional enemy
GarroshWreckingBallUnrivaledStrength=Increase Wrecking Ball's throw range, damage
GenericAmplifiedHealingTalent=All healing effects increased
GenericArcanePowerHotbar=Increases Spell Power and restores Mana
GenericBattleMomentumTalent=Basic Attacks decrease Ability cooldowns
GenericBlockTalent=Periodically gain Physical Armor
GenericBlockTalentFace=Periodically gain Physical Armor
GenericBloodForBloodHotbar=Activate to steal Health from your target
GenericBoltoftheStormTalent=Activate to teleport a short distance
GenericBribe=Kill Minions to bribe a Mercenary
GenericBribeTalent=Kill Minions to bribe a Mercenary
GenericBurningRageTalent=Deals damage to nearby enemies
GenericCalldownMule=Activate to heal Structures
GenericClairvoyance=Activate to reveal target area and nearby enemies
GenericCleanse=Makes target ally Unstoppable
GenericDemolitionistTalent=Basic Attacks destroy ammo and deal extra damage to Structures
GenericEnvenomTalent=Activate to deal damage over time
GenericExecutionerTalent=Attacking disabled Heroes increases damage
GenericFirstAid=Activate to heal over time
GenericFirstAid2=Activate to heal over time
GenericFocusedAttackTalent=Periodically empower Basic Attacks against Heroes
GenericFollowThroughTalent=Abilities increase Basic Attack damage
GenericFuryoftheStormTalent=Basic Attacks deal damage to nearby enemies
GenericGatheringPowerTalent=<c val="#TooltipQuest">Quest:</c> Takedowns grant Spell Power
GenericGiantKiller=Empowers your Basic Attacks against Heroes
GenericHardenedFocusTalent=Faster cooldowns near full Health
GenericHealingWardTalent=Activate to place a ward which heals in an area
GenericIceBlockTalent=Activate to become Invulnerable
GenericImposingPresenceTalent=Activate to slow enemy Basic Attacks and Move Speed
GenericMercenaryLordTalent=Empower nearby Mercenaries
GenericOverdriveTalent=Activate to empower your Abilities for extra Mana
GenericPromote=Target Minion takes less and deals more damage
GenericProtectiveShield=Activate to shield an allied Hero
GenericRegenerationMasterTalent=<c val="#TooltipQuest">Quest:</c> Regen Globes increase Health Regen
GenericRelentlessTalent=Halves duration of disables
GenericRewindHotbar=Activate to reset cooldowns
GenericScoutingDrone=Reveals a large area, can be killed
GenericSearingAttacks=Activate to increase Basic Attack damage at the cost of Mana
GenericSeasonedMarksmanTalent=<c val="#TooltipQuest">Quest:</c> Kill enemies to empower Basic Attacks
GenericShrinkRayTalent=Activate to reduce an enemy Hero's damage
GenericSpellShieldItemDisabled=Activate to reduce incoming Ability Damage
GenericSpellShieldItemEnabled=Activate to reduce incoming Ability Damage
GenericSpellShieldTalent=Periodically gain temporary Spell Armor
GenericStoneskin=Activate to gain a Shield
GenericStormShield=Activate to grant Shields to all nearby allies
GenericVigorousAssaultTalent=Basic Attacks heal you
GenericVigorousStrikeTalent=Basic Attacks heal you
GenjiCyberAgility=Jump over terrain
GenjiCyberAgilityAgileDismount=Increase Cyber Agility range while Mounted
GenjiCyberAgilityCyberShield=Cyber Agility grants Spell Armor
GenjiCyberAgilityDoubleJump=Cyber Agility gains a second charge
GenjiCyberAgilityPathfinder=Jumping over terrain increases Move Speed
GenjiDeflect=Become Protected and return fire from attacks
GenjiDeflectAugmentedGuard=Gain a Shield after Deflect ends
GenjiDeflectDragonClawTalent=Activate to damage nearby enemies
GenjiDeflectPerfectDefense=Reduce Deflect cooldown
GenjiDeflectReflect=Increase Deflect damage
GenjiDeflectZanshin=<c val="#TooltipQuest">Quest:</c> Deflect hits all nearby Heroes
GenjiDodge=Periodically dodge Basic Attacks
GenjiDragonblade=Unleash the Dragonblade
GenjiDragonbladeAttack=Lunge forward and slash in a huge arc
GenjiDragonbladeTheDragonBecomesMe=Hitting Heroes increases Dragonblade duration
GenjiShuriken=Throw Shuriken in a spread pattern
GenjiShurikenSharpenedStars=Shuriken pierce
GenjiShurikenShingan=Increase Shuriken single-target damage
GenjiShurikenShurikenMastery=<c val="#TooltipQuest">Quest:</c> Increase Shuriken damage and restore charges
GenjiSwiftStrike=Dash forward damaging enemies passed through
GenjiSwiftStrikeFinalCut=Swift Strike deals extra damage after a delay
GenjiSwiftStrikeFlowLikeWater=Hitting Heroes reduces Swift Strike cooldown
GenjiSwiftStrikeSteadyBlade=Swift Strike deals increased damage for each Hero hit
GenjiSwiftStrikeStrikeAtTheHeart=Extra Swift Strike damage at its end
GenjiSwiftStrikeSwiftAsTheWind=Swift Strike grants Move Speed
GenjiXStrike=Deal heavy damage in a cross shape
GenjiXStrikeLivingWeapon=Hero hits reduce X-Strike's cooldown
GhostShipCannonBombard=Bombard enemies with cannon fire
GraveGolemBindingRoots=Damage and root enemies in an area
GraveGolemMegaStun=Damage and stun enemies in a large area
GreymaneAlphaKillerTalent=Increases Worgen Basic Attacks against Heroes
GreymaneCursedBullet=Remove a portion of enemy's current Health
GreymaneCursedBulletGilneanRouletteTalent=Cursed Bullet pierces, lower cooldown
GreymaneDarkflight=Leap at an enemy and shapeshift into a Worgen
GreymaneDarkflightCyclicalNatureTalent=Hitting a Hero with Gilnean Cocktail reduces Darkflight's cooldown
GreymaneDarkflightRunningWildTalent=Increases Darkflight and Disengage range
GreymaneDarkflightThickSkinTalent=Darkflight grants Physical Armor
GreymaneDisengage=Roll away and transform into a Human
GreymaneDisengageEyesInTheDarkTalent=Disengage grants Stealth
GreymaneEagerWolf=Increases Inner Beast Attack Speed
GreymaneGilneanCocktail=Damage the first enemy hit and deal heavy damage behind them
GreymaneGilneanCocktailDraughtOverflowTalent=Increases Gilnean Cocktail explosion length
GreymaneGilneanCocktailIncendiaryElixirTalent=<c val="#TooltipQuest">Quest:</c> Increases Gilnean Cocktail damage
GreymaneGilneanCocktailPerfectAimTalent=Increases Gilnean Cocktail's range and refunds Mana against Heroes
GreymaneGoForTheThroat=Eviscerate a Hero, refresh cooldown if they die
GreymaneHuntersBlunderbussTalent=<c val="#ColorCreamYellow">Human</c> Basic Attacks splash
GreymaneInnerBeast=Gain a massive Attack Speed boost
GreymaneInnerBeastInsatiableTalent=Inner Beast causes Basic Attacks to restore Mana
GreymaneInnerBeastOnTheProwlTalent=Inner Beast increases Movement Speed
GreymaneInnerBeastViciousnessTalent=Increases Inner Beast duration, Abilities refresh
GreymaneInnerBeastWolfheartTalent=Basic Attacks lower Inner Beast cooldown
GreymaneQuicksilverBulletsTalent=Increases Human Basic Attack range
GreymaneRazorSwipe=Swipe forward and damage enemies
GreymaneRazorSwipeUnfetteredAssaultTalent=Increases Razor Swipe range
GreymaneRazorSwipeVisceralAttacksTalent=Basic Attacks reduce Razor Swipe's cooldown
GreymaneToothAndClawTalent=<c val="#ColorViolet">Worgen</c> form Basic Attacks cleave
GreymaneUnleashed=Go for the Throat gets more powerful free casts
GreymaneWizenedDuelistTalent=<c val="#TooltipQuest">Quest:</c> Basic Attack Heroes to gain damage
GreymaneWorgenForm=Able to shapeshift between a Human and a Worgen
GuldanCataclysm=Channel at the target area pulling enemies toward the center and dealing damage upon expiration.
GuldanChaoticEnergy=<c val="#TooltipQuest">Quest:</c> Gather Regen Globes to reduce Mana costs
GuldanConsumeSoul=Instantly kill an enemy Minion to heal
GuldanCorruption=Deals damage over time to enemies in the area
GuldanCorruptionCurseOfExhaustion=Corruption slows enemy Movement Speed
GuldanCorruptionDemonicSight=Corruption reveals enemies
GuldanCorruptionEchoedCorruption=<c val="#TooltipQuest">Quest:</c> Hit <c val="#TooltipNumbers">40</c> Heroes with Corruption to increase strikes
GuldanCorruptionRuinousAffliction=Corruption deals bonus damage
GuldanDarkBargain=Increase Health, respawn time
GuldanDemonicCircle=Summon a Demonic Circle that Gul'dan can teleport to
GuldanDemonicCircleSummon=Summon Demonic Circle
GuldanDemonicCircleTeleport=Teleport to Demonic Circle
GuldanDrainLife=Drain Health from an enemy, dealing damage and healing Gul'dan
GuldanDrainLifeDevourTheFrail=Drain Life deals more damage to weakened enemies
GuldanDrainLifeHarvestLife=Increases healing from Drain Life
GuldanDrainLifeHealthFunnel=Killing enemies with Drain Life refreshes its cooldown
GuldanDrainLifeTalentGlyphofDrainLife=Increases the cast range of Drain Life
GuldanFear=Fear the first enemy hero hit
GuldanFelFlame=Release a wave of flame that damages enemies
GuldanFelFlameBoundByShadow=Fel Flame hits reduce the cooldown of Corruption
GuldanFelFlameFelArmor=Fel Flame grants Spell Armor
GuldanFelFlameRampantHellfire=Increases Fel Flame's damage
GuldanFelFlameTalentPursuitOfFlame=<c val="#TooltipQuest">Quest:</c> Hit <c val="#TooltipNumbers">40</c> Heroes to increase area
GuldanHealthstone=Activate to heal
GuldanHorrify=Deals damage and Fears Heroes
GuldanHorrifyHaunt=Increases Horrify duration, lower enemies' Armor
GuldanLifeTap=Restore Mana at the cost of Health
GuldanLifeTapDarknessWithin=Life Tap to gain Spell Power
GuldanLifeTapHungerforPower=Gain Spell Power but reduce healing received
GuldanLifeTapImprovedLifeTap=Life Tap restores more Mana
GuldanRainOfDestruction=Summon a rain of meteors in an area
GuldanRainOfDestructionDeepImpact=Rain of Destruction slows enemy Movement Speed
GuldanSeedOfCorruption=Deals damage over time to the enemy hero. If they survive, you become afflicted by Seed of Corruption
GuldanSeedOfCorruptionHeroSelect=Deals damage over time to the enemy hero. If they survive, you become afflicted by Seed of Corruption
HanzoBullseye=Sonic Arrow travels faster, Stuns
HanzoDragonsArrow=Fire a global arrow that Stuns, damages
HanzoDragonstrike=Summon a pair of Spirit Dragons to damage enemies
HanzoExplosiveArrows=Storm Bow arrows explode on Minions, Monsters
HanzoFlawlessTechnique=Storm Bow, Basic Attacks empower each other
HanzoFleetofFoot=Storm Bow grants Move Speed
HanzoGiantSlayer=Basic Attacks, Scatter Arrow deal bonus damage
HanzoIgnoreAllDistractions=Basic Attacks instantly kill Minions, increase range
HanzoMountedArchery=Increase Mount Speed, Natural Agility mounts
HanzoNaturalAgility=Jump over terrain
HanzoNeverOutmatched=Basic Attacks reduce Scatter Arrow cooldown
HanzoNinjaAssassin=Storm Bow lowers Natural Agility cooldown
HanzoPOTG=Activate to teleport to Dragon's Arrow
HanzoPerfectAgility=Gain Natural Agility charge, cooldown reduced
HanzoPiercingArrows=Storm Bow, Scatter Arrow pierce
HanzoRedemption=<c val="#TooltipQuest">Quest:</c> Hit Heroes to gain Attack Speed
HanzoScatterArrow=Fire an arrow that ricochets and splits
HanzoSerratedArrows=Scatter Arrow deals more damage to non-Heroes
HanzoSharpenedArrowheads=Basic Attacks, Storm Bow reduce Armor
HanzoSimpleGeometry=<c val="#TooltipQuest">Quest:</c> Gain additional Scatter Arrows
HanzoSonicArrow=Reveal a large area
HanzoStormBow=Charge up to fire a deadly arrow
HanzoTargetPractice=<c val="#TooltipQuest">Quest:</c> Hit all enemy Heroes to empower Storm Bow
HanzoTheDragonAwakens=Abilities and Attacks reduce Dragonstrike cooldown
HanzoTheDragonHungers=Storm Bow grants Spell Power
HardenedShieldTalent=Activate to gain massive Armor
HeroGenericBribeToken=Heal Allies with Soothing Mist to bribe a Mercenary
HeroGenericRegenGlobe=Heals nearby Heroes when picked up
IllidanBetrayersThirst=Basic Attacks heal for part of the damage dealt and reduce Ability cooldowns
IllidanBetrayersThirstHuntersOnslaughtTalent=Damage from Basic Abilities heals
IllidanBetrayersThirstThirstingBladeTalent=Sweeping Strike grants more Lifesteal
IllidanBetrayersThirstThrillOfBattleTalent=Activate to double cooldown reduction
IllidanBladesOfAzzinoth=Activate to increase Basic Attack damage
IllidanDive=Dive and flip over an enemy
IllidanDiveFriendOrFoeTalent=Increases Dive range and can Dive to allies
IllidanDiveLungeTalent=Increased Dive range
IllidanDiveMarkedForDeathTalent=Repeated Dives deal extra damage
IllidanDiveRapidChaseTalent=Dive increases Move Speed
IllidanElusiveStrike=Sweeping Strike reduces Evasion Cooldown
IllidanEvasion=Evade enemy Basic Attacks
IllidanEvasionReflexiveBlockTalent=Dive grants Physical Armor
IllidanEvasionShadowShieldTalent=Evasion grants a Shield
IllidanEvasionSixthSenseTalent=Evasion grants Spell Armor
IllidanFieryBrand=Consecutive Basic Attacks to Heroes are empowered
IllidanMetamorphosis=Damage area and increase max Health
IllidanMetamorphosisDemonicFormTalent=Demon form lasts forever, grants Attack Speed
IllidanNimbleDefender=Sweeping Strike grants Armor
IllidanSweepingStrike=Dash and damage enemies while gaining Basic Attack damage
IllidanSweepingStrikeBatteredAssaultTalent=Increases Sweeping Strike damage bonus
IllidanSweepingStrikeImmolationTalent=Sweeping Strike deals area damage
IllidanSweepingStrikeSecondSweepTalent=Can store 2 charges of Sweeping Strike
IllidanSweepingStrikeUnboundTalent=<c val="#TooltipQuest">Quest:</c> Sweeping Strike can go over terrain
IllidanTheHunt=Charge a target from a very long range
IllidanTheHuntNowhereToHideTalent=Increases The Hunt range and reveal low Health Heroes
IllidanUnendingHatredSweekingStrikeBonus=Sweeping Strike does bonus damage
IllidanUnendingHatredTalent=<c val="#TooltipQuest">Quest:</c> Killing enemies grants Basic Attack damage
JainaBlizzard=Creates a storm of ice at target location, damaging and slowing enemies
JainaBlizzardSnowstormTalent=Increase Blizzard radius
JainaBlizzardStormFrontTalent=Increase Blizzard cast range
JainaConeOfCold=Deal damage in a cone and Chill targets
JainaConeOfColdIceFloesTalent=Increase Cone of Cold area, reduce cooldown
JainaConeOfColdNorthernExposureTalent=Cone of Cold lowers Armor
JainaConeOfColdNumbingBlastTalent=Cone of Cold Roots Chilled targets
JainaFingersOfFrost=<c val="#TooltipQuest">Quest:</c> Regen Globes increase Mana Regeneration
JainaFrigidTransmission=Activate to teleport and Chill nearby enemies
JainaFrostbiteArcaneIntellectTalent=Damage to Chilled targets returns Mana
JainaFrostbiteDeepChillTalent=Chill Slow stacks
JainaFrostbiteFrostArmorTalent=Chill attackers and gain Physical Armor
JainaFrostbiteFrostbittenTalent=Increases damage bonus
JainaFrostbiteIceBarrierTalent=Damaging Chilled targets grants Shield
JainaFrostbiteLingeringChillTalent=Increase Chill duration
JainaFrostbolt=Shoot a bolt that deals damage and Chills the target
JainaFrostboltFrostShardsTalent=Frostbolt pierces first target
JainaFrostboltIceLanceTalent=Reduce Frostbolt cooldown on Chilled targets
JainaFrostboltWintersReachTalent=Increase Frostbolt range
JainaIcefuryWand=Increase Basic Attack damage
JainaIcyVeinsHotbar=Reduce cooldowns and Mana costs
JainaImprovedIceBlockHotbar=Gain Invulnerability and Chill enemies
JainaRingOfFrost=Create a ring that damages and Roots enemies 
JainaRingOfFrostColdSnapTalent=Ring of Frost center deals damage, Roots
JainaSummonWaterElemental=Summon a Water Elemental that Chills enemies
JainaSummonWaterElementalWintermuteTalent=Increase cast range and mimics Basic Abilities
JainaTraitFrostbite=Jaina's Abilities Chill targets, slowing them and causing them to take more damage
JohannaBlessedMomentum=Basic Attacks reduce Ability cooldowns
JunkratBOOMPOWConcussionMineTalent=Hitting Heroes reduces Concussion Mine cooldown
JunkratBigAsSteelTrapTalent=Increase Steel Trap radius, damage
JunkratBoggedDownConcussionMineTalent=Concussion Mine Slows
JunkratBonzerHitsConcussionMineTalent=<c val="#TooltipQuest">Quest:</c> Increase Concussion Mine Knockback, damage
JunkratBurstFireFragLauncherTalent=Frag Launcher burst fires
JunkratCannonballFragLauncherTalent=Bigger Basic Attack, Frag Launcher explosions
JunkratChatteringTeethSteelTrapTalent=Steel Traps chase Heroes
JunkratConcussionMine=Place a mine that can be detonated
JunkratDetonateMine=Detonate the Concussion Mine
JunkratDetonateRIPTire=Instantly destroy the RIP-Tire
JunkratEndlessNadesFragLauncherTalent=Hitting Heroes reduces Frag Launcher cooldown
JunkratExtraOomphRIPTireTalent=Increase RIP-Tire knockback, reduce cooldown
JunkratExtraWoundTimersFragLauncherTalent=Frag Launcher grenades last longer
JunkratFragLauncher=Launch a bouncing grenade
JunkratFragLauncherBouncyBouncy=Frag Launcher grenades gain damage after ricochet
JunkratGottaTrapEmAllSteelTrapTalent=<c val="#TooltipQuest">Quest:</c> Increase Steel Trap count
JunkratPuckishScampRocketRideTalent=Reduce Rocket Ride cooldown
JunkratPutSomeEnglishOnItFragLauncherTalent=Increase Frag Launcher distance
JunkratRIPTire=Create a motorized bomb that explodes
JunkratRIPTireJump=Jump!
JunkratRipperAirConcussionMineTalent=Concussion Mine knocks Junkrat farther
JunkratRocketRide=Launch into the air, damaging enemies upon landing
JunkratSpreadVolleyFragLauncherTalent=Activate to make Frag Launcher spread
JunkratSteelTrap=Place a trap that Roots enemies
JunkratStickyWicketSteelTrapTalent=Steel Trap Slows, no longer Roots
JunkratTasteForExplosionsFragLauncherTalent=<c val="#TooltipQuest">Quest:</c> Increase Frag Launcher damage
JunkratTotalMayhem=Drop grenades upon death
JunkratTrickyShufflesFragLauncherTalent=Gain Move Speed while Frag Launcher replenishing
KaelthasArcaneBarrier=Gain a Shield based on maximum Mana
KaelthasArcaneDynamo=Using Basic Abilities increases Spell Power
KaelthasBurnedFleshTalent=Empower Flamestrike against multiple Heroes
KaelthasFlamestrike=Deal damage in an area
KaelthasFlamestrikeConvectionTalent=<c val="#TooltipQuest">Quest:</c> Flamestrike hits increase damage
KaelthasFlamestrikeFuryOfTheSunwellTalent=Flamestrike explodes twice
KaelthasFlamethrowerTalent=Increases Flamestrike's range
KaelthasGravityLapse=Stun an enemy
KaelthasGravityLapseEnergyRoilTalent=Reduce Gravity Lapse cooldown on Heroes
KaelthasGravityLapseGravityThrowTalent=Increases Gravity Lapse stun duration
KaelthasGravityLapseNetherWindTalent=Increases Gravity Lapse range and restores Mana
KaelthasGravityLapseTriOptimalTalent=Gravity Lapse reduces Verdant Spheres' cooldown
KaelthasLivingBomb=Damage an enemy over time, eventually exploding in an area around them
KaelthasLivingBombBackdraftTalent=Living Bomb explosion slows enemies
KaelthasLivingBombChainBombTalent=Living Bomb explosion spreads Living Bomb
KaelthasLivingBombFissionBombTalent=Increases Living Bomb explosion radius
KaelthasLivingBombPyromaniacTalent=Living Bomb reduces Basic Ability cooldowns
KaelthasLivingBombSunKingsFury=Living Bomb deals more damage after spreading
KaelthasMakethemPayLivingBomb=Living Bomb explodes a second time
KaelthasManaAddictTalent=<c val="#TooltipQuest">Quest:</c> Regen Globes grant Arcane Barrier
KaelthasManaTapTalent=Verdant Spheres restores Mana
KaelthasPhoenix=Summon a Phoenix to burn enemies
KaelthasPhoenixRebirthTalent=Increases Phoenix duration and may retarget
KaelthasPyroblast=Blast an enemy with a big fireball
KaelthasPyroblastPresenceOfMindTalent=Increases Pyroblast radius and lowers cooldown
KaelthasSunfireEnchantmentTalent=Special attack on Verdant Spheres activation
KaelthasVerdantSpheres=Make Kael'thas's next Basic Ability more powerful
KaelthasVerdantSpheresFelInfusionTalent=Increases Spell Power, Verdant Spheres heals
KaelthasMasterOfFlamesLivingBomb=Living Bomb spreads indefinitely
KaelthasVerdantSpheresTwinSpheresTalent=Verdant Spheres gains a second charge
KelThuzadAcceleratedDecay=Death and Decay damage increases
KelThuzadArcaneEchoes=Reduce Death and Decay cooldown
KelThuzadArchlichArmor=Activate to gain Physical Armor, Slow enemies
KelThuzadBarbedChains=Chains deals more damage, reduces Armor
KelThuzadBlightedFrost=Increase Frost Nova center damage, duration
KelThuzadChainLink=Pulling Heroes together reduces Chains cooldown
KelThuzadChains=Pull enemies together
KelThuzadChainsLink=
KelThuzadChainsOfIce=Chains Slows after pull
KelThuzadChillingTouch=Basic Attacks periodically deal area Spell damage
KelThuzadDarkBlast=Damage enemies in an area
KelThuzadDeathAndDecay=Damage enemies and create a damaging pool
KelThuzadDeathchill=Frost Blast Slows, Takedowns release blasts
KelThuzadFrostNova=Damage and disable enemies
KelThuzadFrozenTomb=Root and damage enemies around a target
KelThuzadGlacialSpike=Create a spike that explodes, deals damage
KelThuzadHungeringCold=Frost Nova makes enemies take bonus damage
KelThuzadIcyGrasp=Increase Frost Nova Slow duration
KelThuzadLifeDevourer=Death and Decay explosion heals on Hero hits
KelThuzadMasterOfTheColdDark=Kel'Thuzad becomes increasingly stronger as he disrupts enemies
KelThuzadMasterOfTheColdDarkQuestToken=<img path="@UI/StormTalentInTextQuestIcon" alignment="uppermiddle" color="B48E4C" width="20" height="22"/><c val="#TooltipQuest">Quest:</c> Gain <c val="#TooltipNumbers"><d ref="Effect,KelThuzadMasterOfTheColdDarkModifyToken,Value"/></c> Blight every time a Hero is Rooted by Frost Nova or hit by Chains of Kel'Thuzad.<n/><n/><img path="@UI/StormTalentInTextQuestIcon" alignment="uppermiddle" color="B48E4C" width="20" height="22"/><c val="#TooltipQuest">Reward:</c> After gaining <c val="#TooltipNumbers"><d ref="Behavior,KelThuzadMasterOfTheColdDarkToken,ConditionalEvents[0].CompareValue"/></c> Blight, the cooldown of all Basic Abilities is reduced by <c val="#TooltipNumbers"><d ref="Effect,KelThuzadMasterOfTheColdDarkTier1ModifyPlayer,EffectArray[0].Value"/></c> seconds.<n/><n/><img path="@UI/StormTalentInTextQuestIcon" alignment="uppermiddle" color="B48E4C" width="20" height="22"/><c val="#TooltipQuest">Reward:</c> After gaining <c val="#TooltipNumbers"><d ref="Behavior,KelThuzadMasterOfTheColdDarkToken,Max"/></c> Blight, gain <c val="#TooltipNumbers"><d ref="Behavior,KelThuzadMasterOfTheColdDarkSpellPower,Modification.DamageDealtFraction[Ability] * 100"/>%</c> Spell Power.
KelThuzadMasterOfTheDarkArts=Kel'Thuzad becomes increasingly stronger as he deals damage
KelThuzadMightOfTheScourge=Hitting Heroes resets Shadow Fissure cooldown
KelThuzadMrBigglesworth=Scout an area and grant Ability Power if attacked
KelThuzadMrBigglesworthItem=Scout an area and grant Ability Power if attacked
KelThuzadPhylactery=<c val="#TooltipQuest">Quest:</c> Collect Regen Globes for instant respawn
KelThuzadPhylacteryItem=
KelThuzadPowerOfIcecrown=Disabling enemies grants Spell Power
KelThuzadShadowFissure=Deal high damage in an area
KelThuzadShiftingMalice=Activate to dash and deal damage
KelThuzadStripShields=Chains grants Shield, damages Shields
KelThuzadTheDamnedReturn=Create Shades that mimic Death and Decay
KelThuzadThePlaguelands=Increase Death and Decay duration, radius
KelThuzadTheScourging=Inflict rampant death upon a large area
KelThuzadTheScourgingCancel=Cancels The Scourging
KelThuzadUnholyPresence=Move with unholy grace
KelThuzadVoidspike=Damages enemies, obliterates rooted enemies
KerriganAdaptationTalent=Ravage can jump to allies
KerriganAggressiveDefenseTalent=Increases Assimilation Shields gained
KerriganAssimilation=Gain a temporary Shield by attacking enemies
KerriganAssimilationDoubleStrikeTalent=Abilities empower Basic Attacks
KerriganAssimilationFuryOfTheSwarmTalent=Basic Attacks cleave
KerriganAssimilationLingeringEssenceTalent=Increases Assimilation Shield duration
KerriganAssimilationMasteryTalent=Assimilation lasts longer and increases Health and Mana regeneration
KerriganBladedMomentum=Basic Attacks reduce Ability cooldowns
KerriganEssenceForEssenceHotbar=Activate to steal Health from the target
KerriganImpalingBlades=Stun and damage enemies in an area
KerriganImpalingBladesBladeTorrentTalent=Increases Impaling Blades area
KerriganImpalingBladesImpalingSwarmTalent=Impaling Blades spawns <d ref="[d ref='Effect,ImpalingBladesZerglingOffsetCreatePersistent,PeriodCount' player='0'/]"/> Zerglings
KerriganImpalingBladesSharpenedBladesTalent=Impaling Blades deals more damage
KerriganMaelstrom=Persistently damage nearby enemies
KerriganMaelstromOmegastormTalent=Increased Maelstrom size and Shield generation
KerriganPrimalGrasp=Pull and damage enemies in an area
KerriganPrimalGraspEnergizingGraspTalent=Primal Grasp costs less Mana
KerriganPrimalGraspPsionicPulseTalent=Damage nearby enemies
KerriganPsionicShift=Activate to teleport a short distance, deal damage
KerriganQueensRushHotbar=Takedowns increase Move Speed
KerriganRavage=Leap to an enemy and deal damage
KerriganRavageCleanKillTalent=Ravage refunds Mana on kill and increases damage
KerriganRavageEviscerateTalent=Increases Ravage range
KerriganRavageSiphoningImpactTalent=Ravage heals Kerrigan
KerriganSummonUltralisk=Summon an Ultralisk to chase a target
KerriganSummonUltraliskTorrasqueTalent=Ultralisk spawns a new Ultralisk on death
KnightMagicVolley=Repeatedly deal Ability damage to enemies
L90ETCDeathMetalTalent=Dying causes Mosh Pit
L90ETCFaceMelt=Knock back and damage nearby enemies
L90ETCFaceMeltFaceSmeltTalent=Face Melt slows enemies
L90ETCFaceMeltLoudSpeakersTalent=Increases range and knockback of Face Melt
L90ETCGuitarSolo=Regenerate Health
L90ETCGuitarSoloGroupiesTalent=Guitar Solo heals nearby allied Heroes
L90ETCGuitarSoloGuitarHeroTalent=Basic Attacks heal during Guitar Solo
L90ETCMoshPit=Nearby enemies must dance
L90ETCMoshPitTourBusTalent=Makes Powerslide usable during Mosh Pit
L90ETCPowerslide=Dash to an area, stunning and damaging enemies hit
L90ETCRockstar=After using an ability, E.T.C. gains Armor
L90ETCRockstarEchoPedalTalent=Abilities cause area damage
L90ETCStageDive=Dive to a location and deal damage
LeoricBuriedAliveTalent=Entomb damages and Silences
LeoricBurningDespair=Deal damage to nearby enemies
LeoricConsumeVitalityTalent=Skeletal Swing heals
LeoricCrushingHopeTalent=Full duration Drain Hope deals bonus damage
LeoricDeathMarchTalent=March of the Black King applies Drain Hope
LeoricDrainEssence=None
LeoricDrainHope=Drain Health from an enemy Hero while close to them
LeoricDrainMomentumTalent=Drain Hope grants Move Speed
LeoricEntomb=Wall in an area
LeoricFealtyUntoDeathTalent=Gain Health and Mana when Minions die
LeoricGhastlyReachTalent=Increase Skeletal Swing range
LeoricGhastlySwing=None
LeoricHardenedBonesTalent=Gain Armor during Drain Hope
LeoricHopelessnessTalent=Increase Drain Hope range
LeoricKneelPeasantsTalent=Increase Skeletal Swing damage to non-Heroes
LeoricLingeringApparitionTalent=Wraith Walk lasts longer
LeoricMarchoftheBlackKing=March forward, healing Leoric, damaging enemies
LeoricMithrilMaceTalent=<c val="#TooltipQuest">Quest:</c> Empower Wrath Of The Bone King
LeoricMithrilMaceTalentToken=Empower Unholy Mace
LeoricOminousWraithTalent=Empower Wraith Walk
LeoricOsseinRenewal=Activate to heal
LeoricOsseinRenewalHotbar=Activate to heal
LeoricParalyzingRageTalent=Increase Skeletal Swing Slow
LeoricRoyalFocusTalent=Empower Skeletal Swing and Wraith Walk
LeoricShroudoftheDeadKingTalent=Activate to become Protected
LeoricSkeletalSwing=Damage and slow enemies
LeoricSpectralLeechTalent=Basic Attacks deal extra damage and heal
LeoricUndyingTrait=Leoric haunts his enemies as a ghost while dead
LeoricUnyieldingDespairTalent=Reduce Drain Hope cooldown
LeoricWillingVesselTalent=Increase Drain Hope healing
LeoricWraithWalk=Leoric's ghost separates from his body to move unhindered
LeoricWrathOfTheBoneKing=Damage and slow enemies
LiLiBlessingsOfYulon=Increase Cloud Serpent healing
LiLiBlindingWind=Blind and damage nearby enemies
LiLiBlindingWindGaleForceTalent=Increase Blinding Wind duration
LiLiBlindingWindHinderingWindsTalent=Blinding Wind slows targets
LiLiBlindingWindMassVortexTalent=Blinding Wind hits more targets
LiLiCloudSerpent=Summon a serpent to assist an ally
LiLiCloudSerpentLightningSerpentTalent=Cloud Serpent's attacks bounce to Heroes
LiLiEagerAdventurer=Increase Fast Feet duration
LiLiFastFeet=When struck by enemies, gain Movement Speed
LiLiFreeDrinks=Healing Brew cost reduced on low Health targets
LiLiHealingBrew=Heal a nearby ally
LiLiHealingBrewTheGoodStuffTalent=Healing Brew also heals over time
LiLiHealingBrewTwoForOneTalent=Healing Brew heals twice but longer cooldown
LiLiHinderingWinds=Blinding Wind Slows Heroes
LiLiJugof1000Cups=Rapidly heal nearby allies
LiLiJugof1000CupsJugof1000000CupsTalent=Jug of 1,000 cups heals two allies at once
LiLiKungFuHustleTalent=Cooldowns recharge faster when damaged
LiLiLetsGo=Activate to heal ally, make them Unstoppable
LiLiMistweaver=Activate to heal nearby Heroes
LiLiPickMeUp=Healing Brew heals more on low Health targets
LiLiSafetySprintTalent=Activate Fast Feet for a burst of speed
LiLiSerpentSidekickTalent=Hitting Heroes increases Cloud Serpent duration
LiLiShakeItOffTalent=Fast Feet grants Armor
LiLiSurgingWindsTalent=Gain Spell Power from Blinding Wind
LiLiWaterDragon=Damages and heavily slows nearest enemy Hero
LiLiWaterDragonDoubleDragonTalent=Summons two dragons
LiLiWindSerpent=Reduced cooldown, launches Blinding Wind
LostVikingSelectBaleog=<c val="#TooltipNumbers">Baleog</c> deals splash damage to enemies behind his attack target
LostVikingSelectErik=<c val="#TooltipNumbers">Erik</c> moves faster than the other Vikings and has a longer attack range
LostVikingSelectOlaf=<c val="#TooltipNumbers">Olaf</c> has lots of health, regenerates health quickly, and charges to slow enemies
LostVikingsBaleogTheFierceTalent=Baleog's attacks increase his Attack Speed
LostVikingsCheckpointReachedTalent=Additional revive and heal
LostVikingsErikTheSwiftTalent=Increases Erik's Move Speed and heal while running
LostVikingsExplosiveAttacksTalent=Increases Baleog splash to non-Heroic enemies
LostVikingsFuryoftheStormTalent=Basic Attacks chain to non-Heroes
LostVikingsGoGoGo=Gain <c val="#TooltipNumbers">30%</c> increased Movement Speed
LostVikingsGoGoGo64KBMarathonTalent=Run faster and break slows and roots
LostVikingsHunkaBurningOlafTalent=Olaf deals damage to nearby enemies
LostVikingsImpatienceIsAVirtueTalent=Vikings' attacks reduce cooldowns of all Vikings
LostVikingsItsASabotageTalent=Erik's attacks stronger against Structures
LostVikingsJump=Grants temporary Invulnerability
LostVikingsLargeAndInChargeTalent=Charge stuns enemies
LostVikingsLongboatRaid=Load into a Longboat to attack enemies
LostVikingsNordicAttackSquad=Increases Viking Basic Attacks to Heroes
LostVikingsNorseForce=All Vikings gain a Shield
LostVikingsOlafTheStoutTalent=Olaf gains Physical Armor
LostVikingsPainDontHurtTalent=Baleog's attacks heal himself
LostVikingsPlayAgain=Revive and summon Vikings
LostVikingsSpinToWin=Deals damage around each Viking
LostVikingsSpyGamesTalent=Erik gains Stealth and increases vision if stationary
LostVikingsTheSequelTalent=Reduces death timer for all Vikings
LostVikingsVikingBribery=Kill Minions to bribe a Mercenary
LostVikingsVikingBriberyToken=Kill Minions to bribe a Mercenary
LostVikingsVikingHoardHeroSelect=Gather Regen Globes to increase Health Regen
LostVikingsVikingHoardTalent=Gather Regen Globes to increase Health Regen
LostVikingsVikingHoardTokenCounter=Gather Regen Globes to increase Health Regen
LostVikingsWereOnABoatTalent=Increased combat prowess
LucioAmpItUp=Boost the effect of Lúcio's Crossfade track
LucioAmpItUpBringItTogether=<c val="FFF800">Healing Boost</c> increased near allies
LucioAmpItUpMaximumTempo=<c val="#TooltipQuest">Quest:</c> Hero kills increase Amp It Up speed
LucioAmpItUpRejuvenescencia=<c val="FFF800">Healing Boost</c> also heals a percentage of life
LucioAmpItUpSonicAmplifier=Amp It Up increases Crossfade radius
LucioAmpItUpSynaesthesiaAuditiva=Casting Amp It Up removes Stuns, Slows, and Roots
LucioAmpItUpUpTheFrequency=Basic Attacks lower Amp It Up's cooldown
LucioAmptItUpBonusTrack=Using Crossfade refreshes Amp It Up
LucioBackInTheMix=Heal self on Stun, Silence, or Time Stop
LucioBoomboxBoombox=Drop a boombox that plays Crossfade
LucioCrossfadeActivateHealingBoost=Play a <c val="FFF800">Healing Boost</c> or <c val="3DFF7F">Speed Boost</c> track
LucioCrossfadeActivateSpeedBoost=Play a <c val="FFF800">Healing Boost</c> or <c val="3DFF7F">Speed Boost</c> track
LucioCrossfadeBeatMixing=Gain a Shield after switching Crossfade tracks
LucioCrossfadePartyMix=<c val="#TooltipQuest">Quest:</c> Playing Crossfade for Allies increases range
LucioCrossfadeShop=Play a <c val="FFF800">Healing Boost</c> or <c val="3DFF7F">Speed Boost</c> track
LucioCrossfadeSpeedBoostWeMoveTogether=Increase Move Speed of Crossfade <c val="3DFF7F">Speed Boost</c>
LucioCrossfadeUITooltip=Allies within <c val="FFF800">Healing Boost</c> or <c val="3DFF7F">Speed Boost</c> range.
LucioReverseAmp=Cause Crossfade to damage, slow enemies
LucioReverseAmpNonstopRemix=Reverse Amp lasts forever near multiple enemies
LucioReverseAmpUITooltip=Enemy Heroes within Reverse Amp range.
LucioSkateMode=Lúcio can shoot while moving. Lúcio skates or dies!
LucioSoundBarrier=Shield nearby allies
LucioSoundBarrierBossaNova=Reduce Sound Barrier's cooldown, duration
LucioSoundwave=Knockback nearby enemies
LucioSoundwaveChaseTheBass=<c val="#TooltipQuest">Quest:</c> Enhance Soundwave's arc, range
LucioSoundwaveOffTheWall=Soundwave's cooldown reduced during Wall Ride
LucioSoundwaveSubwoofer=Soundwave pushes close enemies further
LucioWallRide=Lúcio gains Movement Speed near impassable terrain and can move through units
LucioWallRideAccelerando=Wall Ride gradually increases Move Speed
LucioWallRideCantStopWontStop=Immune to Slow and Root effects during Wall Ride
LucioWallRideHardStyle=Gain Armor during Wall Ride
LucioWallRideSlip=Nearby enemy Heroes increase Wall Ride speed
LucioWallRideUITooltip=Lucio's Wall Ride duration.
MaievArmoredAssault=Armor increases Physical Damage dealt
MaievContainmentDisc=Time Stop an enemy Hero and remove their vision
MaievFanOfKnives=Throw a volley of knives
MaievFanOfKnivesBladeDance=Fan of Knives deals Physical Damage around Maiev
MaievFanOfKnivesBladedArmor=Fan of Knives grants Armor
MaievFanOfKnivesElunesWrath=Fan of Knives deals more damage after hitting multiple Heroes
MaievFanOfKnivesNaishasMemento=Activate to make Basic Attacks bounce
MaievFanOfKnivesPinDown=<c val="#TooltipQuest">Quest:</c> Hitting multiple Heroes empowers Fan of Knives
MaievShadowOrbHuntress=Activate to gain Move Speed, Attack Speed
MaievShadowOrbShadowStrike=Activate to Slow, reduce Armor
MaievSpiritOfVengeance=Project a shadow of Maiev that she can later Blink to
MaievSpiritOfVengeanceRuthlessSpirit=Spirit of Vengeance deals more damage per enemy hit
MaievSpiritOfVengeanceShadowArmor=Blink grants Armor
MaievSpiritOfVengeanceShadowOrbVengeance=Activate to reset Spirit of Vengeance cooldown
MaievSpiritOfVengeanceSuddenVengeance=Blink can deal area damage
MaievSpiritOfVengeanceVengefulKnives=Spirit of Vengeance increases Fan of Knives damage
MaievUmbralBind=Tether enemy Heroes to Maiev, pulling those that stray too far
MaievUmbralBindBondsOfCorruption=Umbral Bind pull reduces Physical Armor
MaievUmbralBindBondsOfJustice=<c val="#TooltipQuest">Quest:</c> Secondary tethers increase Umbral Bind damage
MaievUmbralBindChainGang=Multiple Umbral Bind tethers grant Armor
MaievUmbralBindCruelChain=Damage Umbral Bind targets to increase pull damage
MaievUmbralBindPursuitOfVengeance=Umbral Bind tethers reduce Spirit of Vengeance cooldown
MaievVaultOfTheWardens=Leap into the air, becoming temporarily immune
MaievWardensCage=Trap enemies in a cage of Avatars
MalfurionEntanglingRoots=Root and damage Heroes in an area
MalfurionEntanglingRootsDeepRootsTalent=Increases Entangling Roots area and duration
MalfurionEntanglingRootsStranglingVinesTalent=Entangling Roots reduces enemy healing
MalfurionEntanglingRootsTenaciousRootsTalent=Extend Entangling Roots, Stuns reset cooldown
MalfurionEntanglingRootsVengefulRootsTalent=<c val="#TooltipQuest">Quest:</c> Entangling Roots spawns a Treant
MalfurionInnervate=Grant Mana to an ally and reduce their cooldowns
MalfurionInnervateElunesGraceTalent=Increases Basic Ability ranges
MalfurionInnervateShandosClarityTalent=Regrowths increase Innvervate cooldown rate
MalfurionInnervateVersatileTalent=Increases Innervate Mana return
MalfurionMoonfire=Damage enemies in an area, and heal allies with Regrowth
MalfurionMoonfireCelestialAlignmentTalent=Moonfire reveals longer, empowers Attacks
MalfurionMoonfireFullMoonfireTalent=Increases Moonfire area and reduces Mana cost
MalfurionMoonfireHinderingMoonfireTalent=Moonfire Slows
MalfurionMoonfireLunarShowerTalent=Successive Moonfires are more powerful
MalfurionMoonfireMoonlitHarmonyTalent=Moonfire heals more per ally affected by Regrowth
MalfurionNaturesCure=Activate to remove disablers from allies
MalfurionNaturesCureHotbar=[PH] Activate to remove enemy crowd control
MalfurionRampantGrowthTalent=Increases initial heal of Regrowth
MalfurionRegrowth=Heal an allied Hero over time
MalfurionRegrowthEnduringGrowthTalent=Increases Regrowth duration
MalfurionRegrowthHarmonyTalent=Moonfire reduces Mana cost of Regrowth
MalfurionMoonfireWildGrowthTalent=Moonfire extends Regrowth duration
MalfurionRegrowthLifeSeedTalent=Nearby Heroes receive Regrowth periodically
MalfurionRegrowthMoonfireLifebloomTalent=Regrowth instantly heals for missing Health
MalfurionRegrowthNaturesBalanceTalent=Increase Moonfire area, Regrowth duration
MalfurionRegrowthNaturesSwiftnessTalent=Regrowths grant Malfurion Move Speed
MalfurionRevitalizeInnervateTalent=Innervate also benefits Malfurion
MalfurionTranquility=Continually heal nearby allies
MalfurionTranquilitySerenityTalent=Empower Tranquility
MalfurionTwilightDream=Silence and damage nearby enemies
MalfurionTwilightDreamAstralCommunionTalent=Activate to teleport and cast Twilight Dream
MalfurionVengefulRootsEntanglingRootsTalentToken=
MalfurionYserasGift=Increase Regrowth heal at high Health
MalthaelAngelOfDeath=Last Rites heals
MalthaelBlackHarvest=<c val="#TooltipQuest">Quest:</c> Increase Reaper's Mark duration
MalthaelColdHand=Soul Rip Slows
MalthaelDeathShroud=Unleash a wave that applies Reaper's Mark
MalthaelDeathsReach=Increase Wraith Strike range
MalthaelDieAlone=Increase Soul Rip single-target damage
MalthaelEtherealExistence=Marked targets grant Physical Armor
MalthaelFearTheReaper=Activate to increase Movement Speed
MalthaelFinalCurtain=Death Shroud leaves a trail
MalthaelInevitableEnd=Activate to become Unstoppable, remove Marks
MalthaelLastRites=<c val="#TooltipQuest">Quest:</c> Damage a Hero based on their missing Health
MalthaelMassacre=Wraith Strike hits an area
MalthaelMementoMori=Reaper's Mark deals increased damage over time
MalthaelMortality=Wraith Strike deals bonus damage to Heroes
MalthaelNoOneCanStopDeath=Activate to respawn
MalthaelOnAPaleHorse=Increase mounted Movement Speed
MalthaelReaperOfSouls=Hero Takedowns extend Tormented Souls duration
MalthaelReapersMark=Basic Attacks cleave, apply Reaper's Mark
MalthaelShroudOfWisdom=Activate to gain Spell Armor
MalthaelSoulCollector=Increase Soul Rip range, reduce cooldown
MalthaelSoulRip=Damage Marked enemies and heal
MalthaelSoulSiphon=Increase Soul Rip healing
MalthaelThrowingShade=<c val="#TooltipQuest">Quest:</c> Increase Death Shroud range
MalthaelTormentedSouls=Apply Reaper's Mark to nearby enemies
MalthaelTouchOfDeath=Activate to reduce enemy healing
MalthaelWraithStrike=Teleport to a Marked target
MedicAutomatedBlockTalent=Periodically gain Physical Armor
MedicBioshieldTalent=Grants Shield at full Health
MedicBlastShield=Displacement Grenade grants Energy, Shield
MedicCaduceusFeedbackTalent=Basic Attacks generate Energy
MedicCaduceusReactor=Restore Health while channeling Healing Beam
MedicCaduceusReactor20=Increase Caduceus Reactor healing
MedicCaduceusReactor2dot0Talent=Restores Mana and grants Shields
MedicCellularReactorTalent=Consume Energy to heal
MedicClear=<c val="#TooltipQuest">Quest:</c> Hit Heroes to empower Displacement Grenade
MedicClearTalent=Increased area, bigger knockback
MedicCouplesTherapyTalent=Healing Beam also heals Lt. Morales
MedicDetonateDisplacementGrenade=Damages and knocks enemies away
MedicDisplacementGrenade=Damages and knocks enemies away
MedicEMPGrenadeTalent=Displacement Grenade deals more damage to Shields
MedicExtendedCare=Increase Healing Beam range
MedicFirstResponder=Healing Beam empowered at high Energy
MedicHealingBeam=Heals allies over time
MedicHyperactivity=Lower cooldown, increase Movement Speed
MedicInfusedGrenadeTalent=Displacement Grenade refunds Mana on Hero impact
MedicInoculationTalent=Increases Safeguard initial Armor
MedicIntensiveCareTalent=Healing Beam's healing increases over time
MedicLifeSupport=Safeguard generates Energy
MedicMedivacDropship=Transport allies across long distances
MedicPhysicalTherapy=Safeguard removes Slows
MedicPreventativeCareTalent=Healing Beam target reduces enemy Attack Speed
MedicProlongedSafeguard=Increase Safeguard duration
MedicProlongedSafeguardTalent=Increases Safeguard duration
MedicReinforcements=Medivac appears at Altar, reduce cooldown
MedicSafeZoneTalent=Exiting Medivac grants Protected
MedicSafeguard=Grants Armor to the target
MedicSecondOpinion=Reduce Displacement Grenade cooldown
MedicSecondOpinionTalent=Reduces Displacement Grenade cooldown, gains second charge
MedicShieldSequencerTalent=Safeguard gains a second charge
MedicStimDrone=Grant massive Attack and Movement Speed
MedicSystemShockTalent=Displacement Grenade reduces damage dealt
MedicTransfusionTalent=Lasts longer, also affects self
MedicTraumaTriggerTalent=Gain Armor at low Health
MedicUpgradedBallisticsTalent=Increases Displacement Grenade speed and damage
MedicVanadiumPlating=Stuns increase Safeguard Armor, duration
MedivhArcaneBrilliance=Grant Spell Power and Mana to allies
MedivhArcaneRift=Launch an arcane bolt that damages enemies in a line
MedivhArcaneRiftArcaneCharge=Arcane Rift deals more damage after hitting a Hero
MedivhArcaneRiftGuardianOfTirisfal=Arcane Rift kills Minions instantly
MedivhArcaneRiftManaAdept=Increases Arcane Rift Mana refund
MedivhArcaneRiftTheMastersTouch=<c val="#TooltipQuest">Quest:</c> Hit <c val="#TooltipNumbers"><d ref="Behavior,MedivhArcaneRiftTheMastersTouchQuestToken,Max"/></c> Heroes to increase damage
MedivhArcaneRiftTheMastersTouchQuestToken=<img path="@UI/StormTalentInTextQuestIcon" alignment="uppermiddle" color="B48E4C" width="20" height="22"/><c val="#TooltipQuest">Quest:</c> Hit <c val="#TooltipNumbers"><d ref="Behavior,MedivhArcaneRiftTheMastersTouchQuestToken,Max"/></c> enemy Heroes with Arcane Rift without dying.<n/><n/><img path="@UI/StormTalentInTextQuestIcon" alignment="uppermiddle" color="B48E4C" width="20" height="22"/><c val="#TooltipQuest">Reward:</c> Permanently increase the damage dealt by <c val="#TooltipNumbers"><d ref="Effect,MedivhArcaneRiftDamage,FlatModifierArray[MastersTouchDamage].Modifier"/></c> and cooldown reduction for hitting a Hero by <c val="#TooltipNumbers"><d ref="Effect,MedivhArcaneRiftTheMastersTouchQuestCompleteModifyPlayer,EffectArray[0].Value" precision="1"/></c> second.
MedivhDustOfAppearance=Activate to reveal nearby Heroes
MedivhDustofDisappearance=Stealth an allied Hero
MedivhForceOfWill=Protect an allied Hero from damage
MedivhForceOfWillArcaneExplosion=Force of Will deals area damage
MedivhForceOfWillCircleOfProtection=Force of Will applies to allies near target
MedivhForceOfWillEnduringWill=Preventing damage reduces Force of Will cooldown
MedivhForceOfWillReabsorption=Increase Force of Will healing
MedivhForceofMagic=Force of Will can grant Spell Power
MedivhLeyLineSeal=Unleash a wave that Time Stops enemy Heroes
MedivhLeyLineSealMedivhCheats=Ley Line Seal can be redirected while active
MedivhMysticAssault=Arcane Rift empowers Basic Attacks
MedivhPolyBomb=Polymorph a Hero that spreads to other Heroes
MedivhPolyBombGlyphOfPolyBomb=Poly Bomb spreads faster and farther
MedivhPortal=Create a portal that allies can pass through
MedivhPortal2=Create a portal that allies can pass through
MedivhPortalAstralProjection=Increases Portal range
MedivhPortalInstant=Create a portal that allies can pass through
MedivhPortalMageArmor=Using a Portal grants Armor
MedivhPortalPortalMastery=Create a portal that allies can pass through
MedivhPortalPortalMasteryTalent=Place both Portal locations
MedivhPortalQuickening=Reduces Portal cooldown
MedivhPortalRavenFamiliar=Using a Portal grants a Raven Familiar
MedivhPortalStablePortal=Increases Portal uptime
MedivhRavenForm=Transform into a raven
MedivhTemporalFlux=Arcane Rift reduces Heroic cooldown
MedivhTransformRaven=Transform into a raven
MedivhTransformRavenBirdsEyeView=Increases Raven Form vision range
MedivhTransformRavenRavensIntellect=Raven Form increases Health and Mana Regen
MedivhTransformRavenWindsOfCelerity=Increases Raven Form Movement Speed
MonkAirAlly=Place an Air Ally that reveals an area
MonkBlankTrait=Choose a Trait
MonkBlazingFistsTalent=Basic Attacks reduce Deadly Reach cooldown
MonkBlindingSpeedTalent=Radiant Dash more often
MonkBreathOfHeaven=Heal nearby ally Heroes and grant Movement Speed
MonkCleansingTouch=Radiant Dash makes ally Unstoppable
MonkDashofLight=Radiant Dash increases Breath of Heaven healing
MonkDeadlyReach=Increases Attack Speed and Attack Range
MonkDivinePalm=Prevent an ally from death
MonkEarthAlly=Place an Earth Ally that grants Physical Armor
MonkEchoofHeavenTalent=Breath of Heaven heals a second time
MonkElevenSidedStrikeTalent=Seven-Sided Strike hits more
MonkEpiphany=Activate to restore Mana and Radiant Dash charges
MonkFistsofFuryTalent=Increases Deadly Reach duration
MonkHeavenlyZealBreathofHeaven=Breath of Heaven increases allies Move Speed
MonkInsightTalent=<c val="#TooltipQuest">Quest:</c> Basic Attacks restore Mana, lower cooldowns
MonkIronFistsTalent=Basic Attacks deal more damage
MonkOvertakeTalent=Deadly Reach attacks increase Move Speed
MonkPeacefulReposeTalent=Reduces Divine Palm cooldown if they do not die
MonkQuicksilverTalent=Radiant Dash gives Move Speed
MonkRadiantDash=Jump to an ally or enemy
MonkSevenSidedStrike=Become Invulnerable and strike nearby Heroes
MonkSixthSense=Gain Physical Armor while Stunned, Rooted
MonkSoothingBreezeTalent=Breath of Heaven removes silences, blinds, slows and roots
MonkSpiritAlly=Place a Spirit Ally that heals in an area
MonkTranscendenceTalent=Basic Attacks heal
MonkWayoftheHundredFistsTalent=Radiant Dash launches a volley of blows
MuradinAvatar=Temporary Health boost
MuradinAvatarUnstoppableForceTalent=Avatar grants additional bonuses
MuradinBronzebeardRage=Deals damage to nearby enemies
MuradinDwarfToss=Leap to an area, dealing damage to nearby enemies
MuradinDwarfTossDwarfLaunchTalent=Increase Dwarf Toss range
MuradinDwarfTossHeavyImpactTalent=Dwarf Toss briefly slows enemies hit
MuradinGiveEmTheAxeTalent=Attacking disabled Heroes increases damage
MuradinHaymaker=Stun and knock an enemy away
MuradinHaymakerGrandSlamTalent=Increases Haymaker damage and adds charge
MuradinIronforgedMomentum=Basic Attacks reduce Ability cooldowns
MuradinItsHammerTimeToken=Throw a hammer, dealing <c val="#TooltipNumbers"><d ref="Effect,StormBoltDamage,Amount"/></c> damage to the first enemy hit and stunning it for <c val="#TooltipNumbers"><d ref="Behavior,MuradinStormboltStun,Duration" player="0" precision="2"/></c> seconds.<n/><n/><img path="@UI/StormTalentInTextQuestIcon" alignment="uppermiddle" color="B48E4C" width="20" height="22"/><c val="#TooltipQuest">Quest:</c> Hit <c val="#TooltipNumbers" validator="True"><d ref="Behavior,MuradinItsHammerTimeTokenCounter,Max"/></c> Heroes with Storm Bolt.<n/><n/><img path="@UI/StormTalentInTextQuestIcon" alignment="uppermiddle" color="B48E4C" width="20" height="22"/><c val="#TooltipQuest">Reward: </c>Your Basic Attacks reduce the cooldown of Storm Bolt by <c val="#TooltipNumbers"><d ref="-Effect,MuradinHeroWeaponItsHammerTimeStormBoltModifyCooldown,Cost[0].CooldownTimeUse"/></c> second and Storm Bolt pierces the first target hit, hitting an additional target.
MuradinSecondWind=Restore Health when not taking damage
MuradinSecondWindSkullcrackerTalent=Successive Basic Attacks Stun, deal more damage
MuradinSecondWindStoneformTalent=Activate to heal over time
MuradinSecondWindThirdWindTalent=Increases Second Wind's healing
MuradinStormbolt=Throw a hammer, stunning and damaging the first enemy hit
MuradinStormboltInfusedHammerTalent=Refunds Mana if it hits an enemy
MuradinStormboltPerfectStormTalent=<c val="#TooltipQuest">Quest:</c> Hitting Heroes empowers Storm Bolt
MuradinStormboltPiercingBoltTalent=Storm Bolt pierces
MuradinStormboltSledgehammerTalent=Increases Storm Bolt damage to non-Heroes
MuradinThunderclap=Slow and damage nearby enemies
MuradinThunderclapCrowdControlTalent=Reduces Thunder Clap cooldown per target hit
MuradinThunderclapHealingStaticTalent=Thunder Clap heals Muradin
MuradinThunderclapReverberationTalent=Increases duration and Attack Speed reduction
MuradinThunderclapThunderburnTalent=Thunder Clap can strike a second time
MuradinThunderclapThunderstrikeTalent=Increases Thunder Clap damage to one enemy
MurkyAFishyDeal=Kill Minions with Pufferfish to bribe Mercs
MurkyAFishyDealToken=Bribe Mercenaries
MurkyBigTunaKahuna=Increase Health and respawn time
MurkyEggHuntTalent=Place fake Eggs
MurkyEggShell=Spawning from Egg grants Shield
MurkyFishEye=Egg sees further, detects Stealth
MurkyFishOil=Casts Slime at Pufferfish location
MurkyFishTank=Basic Attacks grant Physical Armor
MurkyLivingTheDreamQuestToken=<c val="#TooltipQuest">Quest:</c> Living increases Spell Power
MurkyLivingTheDreamTalent=<c val="#TooltipQuest">Quest:</c> Living increases Spell Power
MurkyMakingInky=Reduced Slime cooldown
MurkyMarchOfTheMurlocs=Swarm enemies with Murlocs
MurkyMarchOfTheMurlocsNeverEndingMurlocsTalent=March of the Murlocs can channel forever
MurkyOctoGrab=Stun and poke an enemy Hero
MurkyOctoGrabAndASharkTooTalent=Increase Octo-Grab's damage
MurkyPufferfish=Spit out a fish that explodes after a delay
MurkyPufferfishTufferfishTalent=Pufferfish gains Spell Armor, damage
MurkyPufferfishWrathOfCodTalent=Increase Pufferfish damage on Heroes
MurkyRejuvenatingBubbleTalent=Safety Bubble heals
MurkySafetyBubble=Becomes Invulnerable, but cannot attack or use abilities
MurkySafetyBubbleSlipperyWhenWetTalent=Move faster during Safety Bubble, reduce cooldown
MurkySlime=Release Slime to damage and slow enemies
MurkySlimeBlackLagoonTalent=Increases Slime radius
MurkySlimeTime=<c val="#TooltipQuest">Quest:</c> Slime Heroes to empower Slime
MurkySlimeTimeToken=Slime Heroes to empower Slime
MurkySpawnEgg=Place an Egg, from which Murky will respawn
MurkySpawnEggLivingtheDream=Place an Egg, where you can respawn from
MurkyTimetoKrill=Basic Attacks slow enemies
MurkyToxicBuildup=Successive Basic Attacks cast Slime
NecromancerAmplifyDamage=Bone Prison lowers Armor
NecromancerAndarielsVisage=Poison Nova heals, increase Skeleton damage
NecromancerBoneArmor=Activate to gain a Shield
NecromancerBoneArmorBacklash=Bone Armor explodes for damage
NecromancerBoneArmorShackler=Bone Armor Slows, can reduce cooldown
NecromancerBoneArmorShade=Bone Armor evades Basic Attacks
NecromancerBonePrison=Root an enemy in place
NecromancerBoneSpear=Damage enemies in a line
NecromancerColdHandOfDeath=Increase Skeletal Mages Slow, Skeleton attacks Slow
NecromancerCursedStrikes=Basic Attacks deal damage in an area and reduce Attack Speed
NecromancerCursedStrikesGrimScythe=Reduce Cursed Strikes cooldown
NecromancerCursedStrikesRapidHarvest=Cursed Strikes increases Attack Speed
NecromancerEchoesOfDeathTalent=Spectral Scythe spawns additional scythes
NecromancerHarvestVitality=Cursed Strikes against Heroes heals
NecromancerJailors=<c val="#TooltipQuest">Quest:</c> Bone Prison spawns Skeletal Warriors
NecromancerMortalWound=Spectral Scythe reduces healing taken
NecromancerPoisonNova=Poison enemies in a large area
NecromancerPoisonNovaTalent=Poison nearby enemies
NecromancerRaiseSkeleton=Spawn Skeletal Warriors from Minions
NecromancerReapersTollTalent=<c val="#TooltipQuest">Quest:</c> Lower Spectral Scythe cooldown
NecromancerSkeletalMages=Summon Frost Mages to damage and Slow enemies
NecromancerSpectralScythe=Throw a scythe that damages enemies as it returns to Xul
NecromancerTalentCorpseExplosion=Skeletal Warriors explode on death
NecromancerTalentKalansEdict=Skeletal Warrior attacks reduce Heroic cooldown
NecromancerTragOulsEssence=Skeletal Warrior attacks restore Health, Mana
NecromancerWeaken=Increase Cursed Strikes Attack Speed reduction
NexusBladesTalent=Basic Attacks deal more damage and Slow
NexusFrenzyTalent=Increases Attack Speed and Range
NovaAntiArmorShellsTalent=Basic Attacks hit harder, reduce Physical Armor
NovaCovertMission=Kill Minions or Heroes to bribe a Mercenary
NovaCovertMissionTalent=Kill Minions or Heroes to bribe a Mercenary
NovaCovertMissionToken=Kill Minions to bribe a Mercenary
NovaCovertOpsTalent=Stealth enhances Pinning Shot slow and cost
NovaCovertOpsTalent2=Increase Pinning Shot slow while Cloaked
NovaGhostProtocol=Instantly Stealth and spawn a Holo Decoy at your location
NovaGhostProtocolApolloSuitTalent=Reduce Permanent Cloak cooldown
NovaHoloDecoy=Create a hologram decoy of Nova
NovaHoloDecoyHoloStabilityTalent=Increase Holo Decoy range, duration
NovaHoloDecoyLethalDecoyTalent=Holo Decoy deals more damage
NovaHoloDecoyRapidProjectionTalent=Reduces Holo Decoy cooldown and Mana cost
NovaHoloDecoyRemoteDeliveryTalent=Increases Holo Decoy cast and sight range
NovaIonicForceFieldTalent=Gain Armor after Stealth breaks
NovaOneintheChamberTalent=Using an Ability empowers next Basic Attack
NovaPerfectShotTalent=Increase Snipe stacks, Hero hits reduce cooldown
NovaPermanentCloak=Stealth and gain Move Speed while not attacking or taking damage
NovaPermanentCloakSniperAdvancedCloakingTalent=Stealth grants Move Speed, Mana regen
NovaPermanentCloakSniperTacticalEspionageTalent=Increases Mana regen while Cloaked
NovaPinningShot=Slow and damage an enemy
NovaPinningShotCripplingShotTalent=Pinning Shot lowers Armor
NovaPinningShotDoubleTapTalent=Pinning Shot gains a charge, cooldown increased
NovaPinningShotLongshotTalent=Increases Pinning Shot range
NovaPinningShotTazerRoundsTalent=Increased Pinning Shot slow duration
NovaPrecisionSniperTabScreen=Hitting an enemy Hero with Snipe permanently increases the damage of Snipe by <c val="#TooltipNumbers"><d ref="100*Accumulator,NovaPrecisionSniperAccumulator,Scale"/>%</c>, Stacking up to <c val="#TooltipNumbers"><d ref="100*Accumulator,NovaPrecisionSniperAccumulator,MaxAccumulation"/></c>%. When you are at max stacks, the damage is increased by an additional <c val="#TooltipNumbers"><d ref="100*Effect,StormSnipeDamage,MultiplicativeModifierArray[PrecisionSniperMax].Modifier"/>%</c>. All stacks are lost if Snipe fails to hit an enemy.
NovaPrecisionStrike=Area attack with unlimited range
NovaPrecisionStrikePrecisionBarrageTalent=Lower Precision Strike cooldown, gain charge
NovaSnipe=Fire a shot and deal a large amount of damage to the first enemy hit
NovaSnipeAmbushSnipeTalent=Increased Snipe range while Cloaked
NovaSnipeExplosiveRoundTalent=Snipe deals damage in an area
NovaSnipeHotShotTalent=Hitting Heroes increases Snipe damage
NovaSnipeMasterTalent=Increases Snipe damage from hitting Heroes
NovaSnipePsiOpRangefinderTalent=Increases Snipe's Range and lowers Cooldown
NovaSnipePsionicEfficiencyTalent=Increase Snipe range, hitting Heroes refunds Mana
NovaSnipeRailgunTalent=Snipe penetrates through enemies and cooldown is reduced
NovaTripleTap=Fire at a target 3 times
NovaTripleTapFastReloadTalent=Triple Tap cooldown resets on Hero kills
NullificationShieldTalent=Activate to gain massive Spell Armor
ProbiusPhotonCannon=Create a cannon that attacks nearby enemies
ProbiusPylonOvercharge=Weaponize Pylons
ProbiusWarpInPylon=Summon a Pylon that renergizes Probius and allows the construction of other buildings
ProbiusWarpRift=Create a rift that slows enemies and can be detonated with Disruption Pulse
ProbiusConstructAdditionalPylonsPylonOverchargeTalent=Increase max Pylon count and Pylon Overcharge damage
ProbiusDisruptionPulse=Fire a missile in a line that damages enemies and detonates Warp Rifts
ProbiusEchoPulseDisruptionPulseTalent=Disruption Pulse returns to Probius
ProbiusGateKeeperNullGateTalent=Indefinite duration while in Pylon Power
ProbiusGatherMineralsPhotonCannonQuestTalent=<c val="#TooltipQuest">Quest: </c>Collect Minerals to empower Photon Cannons
ProbiusGatherMineralsPhotonCannonTalentTokenBehavior=<c val="#TooltipQuest">Quest: </c>Collect Minerals to permanently empower Photon Cannons
ProbiusGravityWellWarpRiftTalent=Increase Warp Rift Slow amount in center
ProbiusInterferenceWarpRiftTalent=Warp Rift explosions reduce enemy Spell Power
ProbiusNullGate=Create a slowing barrier
ProbiusParticleAcceleratorDisruptionPulseTalent=Increase damage for each target hit
ProbiusPhotonBarrierPhotonCannonTalent=Gain Spell Armor while Photon Cannon is Active
ProbiusPowerOverflowingWarpInPylonTalent=Power Fields give Spell Power, Mana
ProbiusProbiusLoopWarpRiftTalent=Create new Warp Rifts by hitting Heroes with explosions
ProbiusPylonAggressiveMatrixWarpInPylonTalent=Power Fields give Attack Damage
ProbiusQuantumEntanglementWarpRiftTalent=Warp Rift's slow lingers
ProbiusRepulsorWarpRiftTalent=Enemies are knocked away from Warp Rift detonations
ProbiusRiftShockWarpRiftTalent=Deal more damage to enemies caught in Warp Rift detonations
ProbiusShieldBatteryWarpInPylonTalent=Power Fields grant Shields
ProbiusShieldCapacitorTalent=Gain permanent Shields
ProbiusShootEmUpDisruptionPulseTalent=Hitting a Warp Rift splits Disruption Pulse into several additional pulses
ProbiusTowerDefensePhotonCannonTalent=Reduce Photon Cannon cooldown
ProbiusTurboChargedWorkerRushTalent=Move faster and decrease Worker Rush's cooldown
ProbiusWarpRiftWarpResonanceQuestTalent=<c val="#TooltipQuest"> Quest:</c> Detonate Warp Rift on Heroes
ProbiusWorkerRush=Move faster passively.  Activate to move even faster.
RagnarosBigRagExplosiveRune=Cause a delayed explosion in a large area
RagnarosBigRagMeteorShower=Summon a line of meteors
RagnarosBigRagMoltenSwing=Stun and damage nearby enemies
RagnarosBigRagReturnMoltenCore=Return to original form
RagnarosBlastWave=Cause a delayed explosion around an ally
RagnarosBlastWaveBlastEcho=A second Blast Wave is created after the first
RagnarosBlastWaveEngulfingFlame=Increase Blast Wave damage, radius
RagnarosBlastWaveSlowBurn=Blast Wave slows enemies
RagnarosBlastWaveSuperheated=Blast Wave damage increased when used on Ragnaros
RagnarosBlastWaveTemperedFlame=Blast Wave damage gives Shields
RagnarosBlisteringAttacks=Periodically empower Basic Attacks against Heroes
RagnarosCatchingFireItem=Activate to gain Resistant for a short time
RagnarosCatchingFireTalent=<c val="#TooltipQuest">Quest:</c> Regen Globes increase Health Regen
RagnarosEmpowerSulfuras=Deal damage in an area and heal Ragnaros
RagnarosEmpowerSulfurasCauterizeWounds=Empower Sulfuras healing increased
RagnarosEmpowerSulfurasGiantScorcher=Empower Sulfuras deals extra damage to Heroes
RagnarosEmpowerSulfurasHandOfRagnaros=Reduce Empower Sulfuras cooldown
RagnarosEmpowerSulfurasSulfurasHungers=<c val="#TooltipQuest">Quest:</c> Kill Minions with Empower Sulfuras to increase its damage
RagnarosLavaWaveLavaSurge=Lava Wave has two charges
RagnarosLavaWaveTargetPoint=Send a wave of lava down a lane
RagnarosLivingMeteor=Summon a meteor to damage enemies in a line
RagnarosLivingMeteorFireWard=Living Meteor grants Spell Armor
RagnarosLivingMeteorMeteorBomb=Living Meteor explodes at the end of its path
RagnarosLivingMeteorMoltenPower=After hitting Heroes, next Living Meteor deals increased damage
RagnarosLivingMeteorShiftingMeteor=<c val="#TooltipQuest">Quest:</c> Hit Heroes to empower Living Meteor
RagnarosMoltenCore=Take over a destroyed or Allied fort to unleash Ragnaros's full power
RagnarosMoltenCoreHeroicDifficulty=Enhances Molten Core Health, cooldown, damage
RagnarosResilientFlame=Gain Armor when Stunned
RagnarosSubmerge=Activate to heal and enter Stasis
RagnarosSulfurasSmash=Damage and Stun enemies in an area
RagnarosSulfurasSmashFlamesOfSulfuron=Sulfuras Smash slows enemies, stuns longer
RagnarosTributeToTheFirelord=Regen globes reduce Lava Wave cooldown
RaynorACardToPlayTalent=Hero deaths lower Heroic cooldown
RaynorAdrenalineRush=Automatically heal when low on Health
RaynorAdrenalineRushActivatable=Automatically heal when low on Health
RaynorAdrenalineRushFightOrFlightTalent=Adrenaline Rush activateable, grants Armor
RaynorAdrenalineRushGiveMeMoreTalent=Adrenaline Rush heals more
RaynorAdvancedOptics=Increased Basic Attack and sight range
RaynorHyperion=Call down a strafing Battlecruiser
RaynorHyperionGroundStrafeTalent=More shots dealing area damage
RaynorInspire=Increase Attack Speed for self and allies
RaynorInspireRevolutionOverdriveTalent=Gain Movement Speed per inspired Hero
RaynorInspireSteelResolveTalent=Inspire lasts longer
RaynorLeadFromTheFrontPuttinOnAClinicTalent=Reduces cooldowns when killing enemy minions
RaynorPenetratingRound=Fire a shot damaging and knocking back enemies in a line
RaynorPenetratingRoundBullseyeTalent=Penetrating Round stuns first enemy hit
RaynorPenetratingRoundClusterRoundTalent=Increase Penetrating Round damage, width
RaynorPenetratingRoundConfidentAimTalent=Reduces Penetrating Round cooldown
RaynorPenetratingRoundDoubleBarreledTalent=Penetrating Round gains a second charge
RaynorPenetratingRoundHamstringShotTalent=Penetrating Round slows
RaynorRaynorsRaiders=Summon a pair of Banshee escorts<n/>
RaynorRaynorsRaidersDuskWingsTalent=Banshees stay cloaked, attack faster
RaynorRelentlessLeaderTalent=Knock enemies back when Stunned or Rooted
RehgarAncestralHealing=Significantly heal allied Hero
RehgarAncestralHealingFarseersBlessing=Increases heal and heals in area
RehgarBloodAndThunder=Ghost Wolf attacks reduce Basic Ability cooldowns
RehgarBloodlust=Give allied Heroes Movement Speed, Attack Speed, and Life Steal
RehgarBloodlustGladiatorsWarShout=Increases Bloodlust Life Steal
RehgarChainHeal=Create a healing wave that jumps between allies
RehgarChainHealSpiritwalkersGraceTalent=Reduces Chain Heal Mana cost
RehgarChainHealTidalWavesTalent=Reduces Chain Heal cooldown
RehgarEarthbindTotem=Creates a totem that slows nearby enemies
RehgarEarthbindTotemColossalTotem=Increases Earthbind Totem area and range
RehgarEarthbindTotemEarthgraspTotem=Increases Earthbind Totem initial slow
RehgarEarthlivingEnchant=Empowers Chain Heal on low Health Heroes
RehgarFarsight=Activate to reveal target area and nearby enemies
RehgarGhostWolf=Transform into a Ghost Wolf
RehgarGhostWolfActivate=Transform into a Ghost Wolf
RehgarGhostWolfFeralHeartTalent=Increases Health and Mana Regen in Ghost Wolf
RehgarGhostWolfWolfRunTalent=Increases Ghost Wolf Move Speed
RehgarHealingTotem=Activate to place a ward which heals in an area
RehgarHungeroftheWolfTalent=Ghost Wolf attacks do extra damage and heal
RehgarLightningShield=Imbue target ally with lightning, causing damage to nearby enemies
RehgarLightningShieldEarthShield=Lightning Shield gives a Shield
RehgarLightningShieldElectricCharge=Increases Lightning Shield radius
RehgarLightningShieldLightningBond=Lightning Shield is also cast on Rehgar
RehgarLightningShieldReactiveSparkTalent=Reduces Lightning Shield cooldown and waits to start
RehgarLightningShieldRisingStorm=Increases Lightning Shield damage with each hit
RehgarLightningShieldStormcaller=Lightning Shield returns Mana
RehgarTotemicProjection=Instantly move Earthbind Totem to a new location
RexxarAnimalHusbandry=Max Health increase over time
RexxarAspectOfTheHawkTalent=Spirit Swoop increases Attack Speed
RexxarAspectoftheBeastTalent=Misha's Basic Attacks lower Misha, Charge! cooldown
RexxarBarkskinTalent=Misha gains Spell Armor after charging
RexxarBearNecessitiesTalent=Misha's Basic Attacks heal Rexxar
RexxarBestialWrath=Increases Misha's Basic Attacks
RexxarBloodOfTheRhinoTalent=Increases Mend Pet duration
RexxarCripplingTalonsTalent=Increases Spirit Swoop slow amount and duration
RexxarCriticalCareTalent=Increases Mend Pet healing when Misha is low
RexxarDireBeast=Basic Attacks increase damage of Misha, Charge!
RexxarFeignDeath=Become Invulnerable and control Misha
RexxarFlare=Gain vision of an area
RexxarFrenzyofKalimdorTalent=Rexxar's Basic Attacks deal more damage, Misha's attacks slow
RexxarHardenedSkin=Rexxar and Misha gain massive Armor
RexxarHungryBearTalent=Misha's Basic Attacks heal her
RexxarHunterGathererTalent=<c val="#TooltipQuest">Quest:</c> Regen Globes grant Health Regen
RexxarHunterGathererToken=<c val="#TooltipQuest">Quest:</c> Regen Globes grant Health Regen
RexxarMendPet=Heal Misha over time
RexxarMishaChargeRedirect=Order Misha to charge, damaging and stunning enemies
RexxarMishaFocus=Command Misha to move or attack
RexxarMishaFollowHeroSelect=Misha attacks enemies
RexxarSpiritBondEasyPreyTalent=Misha is more effective against Minions and Mercs
RexxarSpiritBondGrizzledFortitudeTalent=Periodically gain Physical Armor
RexxarSpiritBondPrimalIntimidationTalent=Activate to slow enemy Attack and Move speed
RexxarSpiritBondTalent=Misha's Basic Attacks heal Rexxar
RexxarSpiritBondWildfireBearTalent=Misha deals damage to nearby enemies
RexxarSpiritSwoop=Launch a hawk to damage enemies and slow them
RexxarSpiritSwoopBirdOfPreyTalent=Increases Spirit Swoop damage to Minions
RexxarSurvivalistTrainingTalent=Regen Globes restore more Mana
RexxarTakingFlightTalent=Increases Spirit Swoop range, returns Mana
RexxarThrilloftheHuntTalent=Basic Attacks increase Move Speed
RexxarUnleashTheBoars=Send a pack of boars to hunt enemy Heroes
RexxarUnleashTheBoarsKillCommandTalent=Unleash the Boars deals more damage and roots
IllusionMasterImageSelfCast=Switch places with Samuro
SamuroAdvancingStrikes=Increase Movement Speed when attacking Heroes
SamuroBlademastersPursuitTalent=Increase Advancing Strikes Move Speed, duration
SamuroBladestorm=Cause a Bladestorm of destructive force
SamuroBurningBlade=Critical Strike deals area damage
SamuroCriticalStrike=Critically Strike for increased damage.
SamuroDanceOfDeathTalent=Images use Bladestorm
SamuroDeflectionTalent=Advancing Strikes grants Physical Armor
SamuroHarshWinds=Attacks from Wind Walk increase damage
SamuroIllusionMasterTalent=Mirror Images can be controlled
SamuroImageAIDsiabled=Select Samuro Prime
SamuroImageAIEnabled=Select Samuro Prime
SamuroImageDancer=You can control Mirror Images separately or as a group
SamuroImageSwap=Swap positions with target Mirror Image.
SamuroMercilessStrikes=Critically Strike always happens on disabled targets
SamuroMirage=Mirror Image grants Spell Armor
SamuroMirrorImage=Create Mirror Images to confuse and attack enemies
SamuroMirroredSteelTalent=Basic Attacks reduce Mirror Image cooldown
SamuroOneWithTheWindTalent=Gain Armor during Wind Walk
SamuroOverpoweringBlow=Critical Strike gains an additional charge
SamuroPhantomsStrikeTalent=Images increase Critical Strike damage
SamuroPressTheAttack=Advancing Strikes increases Attack Speed
SamuroSelectAll=Select All
SamuroSelectMirrorImages=Select Mirror Image
SamuroSelectSamuroPrime=Select Samuro
SamuroShukuchiTalent=Wind Walk teleports a short distance
SamuroSplitForm=Create two Mirror Images instantly.
SamuroThreeBladeStyleTalent=Images have increased Health and Duration
SamuroWayOfIllusion=<c val="#TooltipQuest">Quest:</c> Image Critical Strikes empower Basic Attacks
SamuroWayOfIllusionComplete=<c val="#TooltipQuest">Quest:</c> Increase Basic Attack damage
SamuroWayOfTheWind=Wind Walk grants extra Move Speed
SamuroWayoftheBlade=Critical Strike happens more often
SamuroWindStrider=Greatly reduce Wind Walk cooldown
SamuroWindwalk=Become Stealthed and gain Movement Speed
WindwalkKawarimiTalent=Wind Walk creates an Image
SgtHammerBluntForceGun=Fire a large bullet across the map
SgtHammerBluntForceGunOrbitalBFGTalent=BFG repeatedly travels through the map
SgtHammerConcussiveBlast=Knock back and damage enemies
SgtHammerConcussiveBlastBarricadeTalent=Concussive Blast creates a wall
SgtHammerConcussiveBlastEntrenchedTalent=Siege Mode empowers Concussive Blast
SgtHammerConcussiveBlastLethalBlastTalent=Increase Concussive Blast damage
SgtHammerGiantKiller=Empowers your Basic Attacks against Heroes
SgtHammerNapalmStrike=Fire damaging napalm at enemies
SgtHammerNapalmStrikeAdvancedLavaStrikeTalent=Increased range and impact damage
SgtHammerNeosteelPlating=Gain temporary Armor
SgtHammerNeosteelPlatingMechanicalKnowhowTalent=Neosteel Plating grants a Shield
SgtHammerNeosteelPlatingSiegeTacticsTalent=Neosteel Plating can grant Unstoppable
SgtHammerSiegeMode=Become immobile to increase range and empower Basic Attacks
SgtHammerSiegeModeAdvancedArtillery=Increase Siege Mode splash damage, radius
SgtHammerSiegeModeAmbushTalent=Siege Mode grants Stealth, extra damage
SgtHammerSiegeModeGraduatingRangeTalent=Gradually gain Basic Attack range in Siege Mode
SgtHammerSiegeModeHoverSiegeModeTalent=Move while in Siege Mode
SgtHammerSiegeModeMaelstromRoundsTalent=Activate to increase Basic Attack damage
SgtHammerSiegeModeRegenerativeBioSteel=Basic Attacks in Siege Mode heal
SgtHammerSiegeModeUltraCapacitors=Siege Mode Attacks grant Attack Speed
SgtHammerSpiderMines=Create mines that slow and damage enemies on contact
SgtHammerSpiderMinesPulseDetonationCoreTalent=Spider Mines detonate multiple times
SgtHammerSpiderMinesShrapnelMines=Spider Mines reduce Armor
SgtHammerSpiderMinesSlowingMinesTalent=Increase slow amount and duration
SgtHammerSpiderMinesTacticalMineDeployment=Thrusters leave behind Spider Mines
SgtHammerThrusters=Activate to gain a burst of Movement Speed
SgtHammerThrustersHyperCoolingEnginesTalent=Siege Mode Attacks reduce Thrusters cooldown
StitchesCannibalize=Basic Attacks against Heroes heal
StitchesDevour=Damage an enemy and restore Health
StitchesDevourChewYourFoodTalent=Devour heals for more over time
StitchesDevourIndigestionTalent=Devour creates a Retchling
StitchesDevourLastBiteTalent=Reduced cooldown on kill
StitchesDevourSavorTheFlavorTalent=<c val="#TooltipQuest">Quest:</c> Devouring Heroes gives permanent Health regen
StitchesFleaBag=Stuns and Roots reduce Cooldowns
StitchesGorge=Completely consume an enemy Hero
StitchesGorgeHungryHungryStitchesTalent=Gorge multiple Heroes, can teleport
StitchesHelpingHand=Pull the first target hit towards Stitches
StitchesHook=Pull the first target hit towards Stitches
StitchesHookFishingHookTalent=Increased range
StitchesHookHelpingHandTalent=Hook can pull allied Heroes with reduced cooldown
StitchesHookHelpingHandTalentCancel=Hook only hits enemies
StitchesHookShishKabobTalent=Hook pulls 2 targets
StitchesHungryforMore=<c val="#TooltipQuest">Quest:</c> Regen Globes increase Health
StitchesPotentBile=Putrid Bile lasts longer and slows more
StitchesPutridBile=Emit a slowing bile puddle
StitchesRestorativeFumes=Vile Gas heals Stitches
StitchesSlam=Damage enemies in an area
StitchesSlamHeavySlamTalent=Increased Slam damage
StitchesSlamMegaSmashTalent=Increases size of Slam
StitchesSlamPulverizeTalent=Reduces Slam cooldown and adds slow
StitchesSlamPutridGroundTalent=Slam infects with Vile Gas
StitchesVileGas=When struck, damage nearby enemies over time
StitchesVileGasTenderizerTalent=Basic Attacks slow enemies
StitchesVileGasToxicGasTalent=Increases area and damage of Vile Gas
StitchesVileGasVileCleaverTalent=Basic Attacks create Vile Gas
StitichesHungryHungryStitchesTeleport=Gorge can eat multiple Heroes and does more damage
StukovBioExplosionSwitchTalent=Bio Kill-Switch detonates Lurking Arm
StukovBioKillSwitch=Detonate Viruses for immediate effects
StukovBioticArmorTalent=Healing Pathogen grants Physical Armor
StukovControlledChaosTalent=Flailing Swipe only hits once, gains multiple charges
StukovEyeInfectionTalent=Increase Weighted Pustule damage, detonation Blinds
StukovFetidTouchTalent=<c val="#TooltipQuest">Quest:</c> Reduce Weighted Pustule cooldown, cost
StukovFlailingSwipe=Knock back enemies in front of Stukov
StukovGrowingInfestationTalent=Lurking Arm expands, cooldown increased
StukovHealingPathogen=Infest allies with a spreading healing Virus
StukovHealingPathogenVigorousReuptakeQuestToken=
StukovLingeringSpinesTalent=Lurking Arm persists after canceling
StukovLongPitchTalent=Increase Weighted Pustule range
StukovLowBlowTalent=Increase Lurking Arm damage to low Health targets
StukovLurkingArm=Continually damage and Silence enemies in an area
StukovLurkingArmItHungersTalent=Hitting Heroes reduces Lurking Arm cooldown
StukovMassiveShove=Shove an enemy until they collide with terrain
StukovOneGoodSpreadTalent=Reduce Healing Pathogen cooldown after spreading
StukovPatientZero2=The primary target of your Hidden and Slowing Pathogens can spread their effects at twice the distance of any other targets.
StukovPoppinPustulesTalent=<c val="#TooltipQuest">Quest:</c> Empower Weighted Pustule
StukovPoxPopuliTalent=Bio-Kill Switch no longer removes Healing Pathogen
StukovPushComesToShoveTalent=Increase Massive Shove speed, can reduce cooldown
StukovReactiveBallistosporesTalent=Radiate Weighted Pustule at low Health
StukovSlowingPathogen=Infect an enemy.
StukovSpineLauncher=Basic attacks are ranged and slow enemies, but do less damage
StukovSpineLauncherTalent=Basic Attacks Slow, become ranged
StukovSuperstrainTalent=Healing Pathogen heals when Stunned, Rooted
StukovTargetedExcisionTalent=Detonate single Weighted Pustule to reduce cooldown
StukovTopOffTalent=Healing Pathogen stronger on high Health target
StukovUniversalCarrierTalent=Healing Pathogen can spread continually
StukovVigorousReuptakeTalent=<c val="#TooltipQuest">Quest:</c> Increase Bio-Kill Switch healing
StukovVirulentReactionTalent=Detonating Weighted Pustule in Lurking Arm Roots
StukovWeightedPustule=Damage enemies and infest them with a Slowing Virus
StukovWithinMyReachTalent=Increase Lurking Arm range
Sundering=Damages, pushes, and Stuns enemies in a line
SylvanasBlackArrows=Attacks and Abilities Stun Minions and Mercenaries, Attacks disable Structures
SylvanasBlackArrowsCorruptionTalent=Basic Attacks destroy Ammo
SylvanasBlackArrowsLifeDrainTalent=Shadow Dagger heals
SylvanasBlackArrowsOverwhelmingAfflictionTalent=Black Arrows slows Heroes
SylvanasBlackArrowsParalysisTalent=Increases Black Arrows duration
SylvanasBlackArrowsUnstablePoisonTalent=Black Arrows explodes Minions on death
SylvanasDarkLadysCallMindControlTalent=Increase Mind Controlled enemies Move Speed
SylvanasDreadfulWake=Haunting Wave stuns Minions and Mercs longer
SylvanasHauntingWave=Deals damage and allows teleportation
SylvanasHauntingWaveFree=Deals damage and allows teleportation
SylvanasHauntingWaveRangersAmbushTalent=Haunting Wave refills Withering Fire
SylvanasHauntingWaveShadeFormTalent=Haunting Wave grants Stealth
SylvanasHauntingWaveWindrunnerTalent=Haunting Wave recharges Withering Fire and is usable twice
SylvanasMercenaryQueenTalent=Nearby Mercs are stronger
SylvanasMindControl=Briefly control an enemy Hero
SylvanasMindControlCancel=Cancel Mind Control
SylvanasPossession=Convert enemy Minions
SylvanasPossessionDarkLadysCallTalent=Increases charges, reduces recharge time, can possess Mercs
SylvanasRemorselessTalent=Abilities increase Basic Attack damage
SylvanasShadowDagger=Damages an enemy over time and spreads
SylvanasShadowDaggerColdEmbraceTalent=Shadow Dagger lowers Armor
SylvanasShadowDaggerLostSoulTalent=Reduces Shadow Dagger cooldown on Heroes
SylvanasWailingArrow=Fire arrow that damages and silences
SylvanasWailingArrowDeafeningBlastTalent=Increases power of Wailing Arrow center
SylvanasWillOfTheForsaken=Activate to gain Unstoppable and Move Speed
SylvanasWitheringFire=Shoot an arrow at the closest enemy. Gains charges when enemies are killed<n/>
SylvanasWitheringFireBarbedShotTalent=Withering Fire deals triple damage to non-Heroic units.
SylvanasWitheringFireEvasiveFireTalent=Withering Fire grants Move Speed
SylvanasWitheringFireOverflowingQuiverTalent=Shoot a free Withering Fire on Minion kills
SylvanasWitheringFireSplinterShotTalent=Withering Fire hits a second enemy
SylvanasWitheringFireWithTheWindTalent=Increases Withering Fire range
SylvanasWitheringFireWitheringBarrage=Withering Fire gains an additional charge and fires faster
TalentBribeToken=Kill Minions to bribe a Mercenary
TalentDampenMagic=Periodically gain Spell Armor
TassadarAdunsWisdom=Oracle reduces Basic Ability cooldowns
TassadarArchon=Become an Archon
TassadarArchonTwilightArchonTalent=Basic Attacks increase Archon duration
TassadarDimensionalShift=Become temporarily invulnerable and invisible
TassadarDimensionalShiftDeepShiftTalent=Increase Dimensional Shift duration, speed
TassadarFocusedBeam=Oracle increases Basic Attack damage
TassadarForceWall=Create an unpathable wall
TassadarForceWallForceBarrierTalent=Force Wall's range, cooldown enhanced
TassadarKhalasCelerity=Plasma Shield gives Move Speed
TassadarKhalasEmbrace=Increased Plasma Shield Life Steal
TassadarKhalasLight=Plasma Shield grants Armor on expiration
TassadarKhaydarinResonance=<c val="#TooltipQuest">Quest: </c>Gather Regen Globes to empower Plasma Shield
TassadarKhaydarinResonanceToken=Regeneration Globes grant additional Mana
TassadarNullification=Greatly lower an enemy Hero's damage
TassadarOracle=Activate to greatly increase vision radius and detect enemy Heroes
TassadarOracleMentalAcuityTalent=<c val="#TooltipQuest">Quest: </c>Takedowns reduce the Cooldown of Oracle
TassadarOracleTemplarsWillTalent=<c val="#TooltipQuest">Quest:</c> Attacking Heroes empowers Distortion Beam
TassadarPhaseDisruption=Psionic Storm lowers Physical Armor
TassadarPlasmaShield=Shield an ally or self temporarily
TassadarPrismaticLink=Basic Attack hits multiple targets
TassadarPsionicEcho=Psionic Storm may be cast a second time
TassadarPsionicProjection=Increases the range of Plasma Shield, Psionic Storm
TassadarPsionicStorm=Damage enemies in an area
TassadarPsionicStormPsiInfusionTalent=<c val="#TooltipQuest">Quest: </c>Psionic Storm returns Mana per target hit
TassadarPsionicStormPsiInfusionTalentToken=Psionic Storm returns Mana per target hit
TassadarPsionicStormResonationTalent=Psionic Storm enhances Distortion Beam
TassadarPsionicStormSecondStrikeTalent2=Can use Psionic Storm twice in succession
TassadarShieldBattery=Activate to grant Plasma Shields to all nearby allies
TassadarTemplarsWill=Regeneration Globes grant additional Mana
TassadrMentalAcuityOracleTalentToken=Reduces Oracle cooldown
ThrallAlphaWolf=Feral Spirit has longer Root, empowers Attacks
ThrallAncestralWrath=Activate to damage and steal Health from a Hero
ThrallChainLightning=Shock enemies with bouncing lightning
ThrallCrashLightning=<c val="#TooltipQuest">Quest:</c> Multiple Hero hits empower Chain Lightning
ThrallEarthenShieldsTalent=Grants allies Shields in area
ThrallEarthquake=Slows enemies in a massive area
ThrallEchooftheElements=<c val="#TooltipQuest">Quest:</c> Killing enemies grants Chain Lightning charge
ThrallFeralResilience=Feral Spirit grants Physical Armor, Frostwolf Resilience
ThrallFeralSpirit=Unleash a wolf spirit to burn enemies and Root Heroes
ThrallForkedLightningTalent=Chain Lightning gains another charge
ThrallFrostwolfPack=<c val="#TooltipQuest">Quest:</c> Reduce Feral Spirit cooldown, cost
ThrallFrostwolfPackToken=<c val="#TooltipQuest">Quest:</c> Hit Heroes to empower Feral Spirit
ThrallFrostwolfResilience=Casting Abilities on enemies grants charges that restore health
ThrallFrostwolfResilienceSurgeOfHealing=Activate Frostwolf Resilience to instantly heal
ThrallGraceOfAirTalent=Windfury grants double Frostwolf Resilience
ThrallMaelstromWeapon=<c val="#TooltipQuest">Quest: </c> Windfury attacks increase Move Speed
ThrallManaTideTalent=Frostwolf Resilience restores Mana, lowers cooldowns
ThrallRabidWolvesTalent=Feral Spirit grants more Frostwolf Resilience
ThrallRestlessWolvesTalent=Reduces Feral Spirit cooldown on Hero impact
ThrallRideTheLightningTalent=Chain Lightning hits more enemies
ThrallRideTheWindTalent=Increases Windfury Move Speed and extends duration on attack
ThrallRollingThunderTalent=Chain Lightning restores Mana, increased range
ThrallSpiritJourneyTalent=Increases Feral Spirit range
ThrallSpiritShield=Periodically gain temporary Spell Armor
ThrallSpiritShieldDisabled=Activate to reduce incoming Ability Damage
ThrallStoneWolvesTalent=Increases Feral Spirit root duration
ThrallTempestFuryTalent=Windfury's final strike hits 3 times
ThrallThunderstorm=<c val="#TooltipQuest">Quest:</c> Hit Heroes to make Chain Lightning Slow
ThrallWindRush=Activate to teleport and gain Windfury
ThrallWindShearTalent=Reduces Windfury cooldown
ThrallWindStalker=<c val="#TooltipQuest">Quest: </c>Windfury attacks empower Windfury
ThrallWorldbreakerTalent=Sundering creates impassable terrain
TinkerARKReaktor=Reduces Xplodium Charge cooldown, can give turret charges
TinkerDethLazor=Charge and shoot a laser. Damage and range increases the longer it is charged
TinkerDethLazorEZPZDimensionalRipperTalent=Deth Lazor disables enemies
TinkerDethLazorGoblinFusionTalent=Deth Lazor deals more damage
TinkerDethLazorHyperfocusCoilsTalent=Deth Lazor charges faster
TinkerFirinMahLazorz=Rock-It! Turrets fire Deth Lazorz
TinkerFocusTurrets=Order turrets to attack a target.
TinkerGoblinRepairs=<c val="#TooltipQuest">Quest:</c> Regen Globes increase Health Regen
TinkerGravOBomb3000=Pulls and damages enemies
TinkerGravOBombMiniatureBlackHoleTalent=Increases Grav-O-Bomb radius and damage
TinkerHiredGoons=Empower nearby Mercenaries. Turrets gain Merc Armor
TinkerItsRainingScrap=Activate to create Scrap
TinkerRoboGoblinMechaLordTalent=Gain Armor, Basic Attack damage
TinkerRoboGoblinPassive=Increase Attack Damage, Armor, Move Speed
TinkerRockItTurret=Create a turret that shoots at nearby enemies
TinkerRockItTurretClockwerkSteamFistsTalent=<c val="#TooltipQuest">Quest:</c> Basic Attacks increase Rock-It! Turret duration
TinkerRockItTurretEngineGunkTalent=Rock-it! Turrets slow enemies
TinkerRockItTurretLongRangedTurretsTalent=Increases Rock-it! Turret attack range
TinkerRockItTurretRockItTurretXLTalent=Rock-It! Turrets attack multiple enemies
TinkerRockItTurretTurretStorageTalent=Increases Rock-it! Turret charges
TinkerSalvager=Turrets and enemy Structures drop Scrap that restore Mana and reduce cooldowns
TinkerSalvagerBreakItDownTalent=Increases Salvager cooldown reduction
TinkerSalvagerReduceReuseRecycleTalent=Enemy Minions can drop Scrap
TinkerSalvagerScrapOMaticSmelterTalent=Increases Salvager Mana restoration
TinkerSuperiorSchematics=Increases Rock-it! Turret range
TinkerXplodiumCharge=Throw a timed bomb which stuns and damages enemies in an area
TinkerXplodiumChargeExtraTNTTalent=Xplodium Charge deals more damage
TinkerXplodiumChargeKwikReleaseChargeTalent=Xplodium Charge gains second charge
TinkerXplodiumChargeXtraLargeBombsTalent=Xplodium Charge casts when Stunned, Rooted
TracerBlink=Dash towards an area
TracerBlinkHeroSelect=Dash towards an area
TracerBulletSprayMelee=Melee hits all enemies in range
TracerBulletTime=Basic Attacks reduce Blink cooldown
TracerCompositionBPulseBomb=Hitting Heroes with Pulse Bomb leaves a second
TracerFocusFire=Unloading a magazine on an enemy does bonus damage
TracerGetStuffedMelee=Reduces Melee cooldown and knocks away
TracerIsthataHealthPack=Increases Regen Globe and Healing Fountain healing
TracerJumper=Increases Blink charges
TracerLeechingRounds=Basic Attacks against Heroes heal
TracerLockedandLoaded=Time Reload perfectly to gain Basic Attack damage
TracerLockedandLoadedAbility=Time Reload perfectly to gain Basic Attack damage
TracerMelee=Attack a nearby enemy
TracerPartingGift=Using Recall leaves bombs
TracerPulseBomb=Attach a bomb to enemies that deals heavy damage
TracerPulseRounds=Increases Pulse Bomb range and charge rate
TracerPulseStrikeMelee=Increases Melee Pulse Bomb charge rate
TracerQuantumSpike=Increases Pulse Bomb single target damage
TracerRecall=Return to a recent location and remove negative effects
TracerReload=Tracer can move while Basic Attacking; Basic Attacks cost ammo
TracerRicochetHeroWeapon=Basic Attacks can bounce to a nearby enemy
TracerSleightofHand=Reload twice as fast
TracerSlipstreamRecall=Recall rewinds more time
TracerSpatialEcho=Takedowns grant Blink charges
TracerStickyBomb=Increases Pulse Bomb area and adds slow
TracerTotalRecallRecall=Recall can restore Health, but has increased cooldown
TracerTracerRounds=Basic Attacks reveal enemies
TracerUntouchable=<c val="#TooltipQuest">Quest:</c> Takedowns increase Attack Damage
TychusCombatTactician=Basic Attacks reduce Run and Gun cooldown
TychusCommandeerOdin=Call down an Odin to pilot
TychusCommandeerOdinAnnihilate=Deals damage in a line
TychusCommandeerOdinBigRedButtonTalent=Increases Odin duration and fires Nukes
TychusCommandeerOdinRagnarokMissilesTargeted=Launch a volley of missiles
TychusCommandeerOdinThrusters=None
TychusDrakkenLaserDrill=Call down a Laser to attack nearby enemies
TychusDrakkenLaserFocusingDiodesTalent=Increase Laser Drill range and damage
TychusFragGrenade=Throw a grenade, damaging and knocking back enemies
TychusFragGrenadeConcussionGrenadeTalent=Increases Frag Grenade radius and knockback
TychusFragGrenadeQuarterbackTalent=Increased Frag Grenade range
TychusFragGrenadeShredderGrenadeTalent=Increased Frag Grenade radius
TychusFragGrenadeTitanGrenadeTalent=Increases Frag Grenade damage to Heroes
TychusFullyLoaded=Reduces Minigun cooldown
TychusIntheRhythmTalent=<c val="#TooltipQuest">Quest:</c> Basic Attacks increase Minigun duration
TychusMasterAssassinTalent=<c val="#TooltipQuest">Quest:</c> Takedowns increase Attack Speed
TychusMinigun=Activate to increase Basic Attack damage to Heroes
TychusMinigunActive=Activate to increase Basic Attack damage to Heroes
TychusNeosteelCoatingTalent=Activate to gain Spell Armor
TychusOverkill=Attack one target while moving, damaging nearby enemies as well
TychusOverkillArmorPiercingRoundsTalent=Increases Overkill damage to main target
TychusOverkillLeadRainTalent=Overkill slows targets
TychusOverkillSprayNPrayTalent=Increases Overkill range
TychusPressTheAdvantage=Run and Gun increases Tychus's Basic Attack range
TychusRelentlessSoldierTalent=Stuns and Roots grant Armor
TychusRunAndGunBobAndWeaveTalent=Adds Run and Gun charges and reduces Mana cost
TychusRunAndGunShrugItOff=Run and Gun grants Resistant
TychusRunandGun=Dash a short distance
TychusRunandGunDashTalent=<c val="#TooltipQuest">Quest:</c> Regen Globes empower Run and Gun
TychusSizzlinAttacks=Basic Attacks deal more damage to Heroes
TychusThatsTheStuff=Minigun damage heals Tychus
TychusTheBiggerTheyAre=Minigun Damage modified based on Target Health
TyraelAngelicMomentum=Basic Attacks reduce Ability cooldowns
TyraelArchangelsWrath=Upon dying, become invulnerable and explode
TyraelArchangelsWrathEvenInDeathTalent=Can use Basic Abilities before exploding
TyraelArchangelsWrathProtectionInDeathTalent=Upon death, grants nearby allies a Shield
TyraelArdentRestoration=Damaging Heroes heals over time
TyraelBurningHalo=El'druin and Tyrael damage nearby enemies
TyraelDefenseOfTheAngels=Activate to gain Armor
TyraelDivineVigor=Smite causes Basic Attacks to heal
TyraelElDruinsMight=Slow and damage enemies in an area. Use ability again to teleport to the area
TyraelElDruinsMightAngelsGraceTalent=El'druin's Might teleport grants Movement Speed
TyraelElDruinsMightBoundByLawTalent=Basic Attacks increase El'druin's Might Slow duration
TyraelElDruinsMightHolyGroundTalent=El'druin's Might teleport makes a blocking field
TyraelElDruinsMightHoradricReforgingTalent=Basic Attacks reduce El'druin's Might cooldown
TyraelElDruinsMightSwordOfJusticeTalent=El'druin's Might can teleport twice
TyraelJudgment=Charge and Stun an enemy Hero
TyraelJudgmentAngelOfJusticeTalent=Judgment has increased range, reduced cooldown
TyraelJusticeForAll=Increase Righteousness Shield on allies
TyraelRighteousness=Gain a temporary Shield
TyraelRighteousnessAngelicAbsorptionTalent=Grants Health Regeneration when attacked
TyraelRighteousnessImposingWillTalent=Slows enemy Attack Speed and Movement Speed
TyraelRighteousnessLawAndOrderTalent=Righteousness, Smite empower each other
TyraelRighteousnessReciprocateTalent=Righteousness Shield explodes
TyraelSalvation=Empower Righteousness, heal if Shield destroyed
TyraelSanctificationHolyArenaTalent=Increase Sanctification duration, empower allies
TyraelSanctificationStationary=Create zone of Invulnerable
TyraelSealofElDruin=Basic Abilities grant Attack Speed
TyraelSmite=Damage an area and speed up nearby allies
TyraelSmiteAngelicMightTalent=Increased Basic Attack damage
TyraelSmitePurgeEvilTalent=Smite increases Basic Attack damage
TyraelSmiteSwiftRetributionTalent=Increase Smite Move Speed, grants Attack Speed
TyraelSmiteTheWicked=El'druin's Might increases Smite cooldown rate
TyraelStalwartAngel=El'druin's Might grants Armor while active
TyrandeDarnassianArchery=Consecutive Basic Attacks deal more damage
TyrandeElunesChosen=Basic Attacks heal target ally
TyrandeEyesOfTheHuntress=Shadowstalk reveals enemy Heroes
TyrandeHarshMoonlight=Sentinel Slows and reduces damage dealt
TyrandeHuntersMark=Lowers Armor and Reveals Marked target
TyrandeHuntersMarkHuntressFuryTalent=Hunter's Mark makes Basic Attacks splash
TyrandeHuntersMarkMarkOfMendingTalent=Marked enemies heal attackers
TyrandeHuntersMarkRangersMarkTalent=<c val="#TooltipQuest">Quest:</c> Basic Attacks empower Hunter's Mark
TyrandeHuntersMarkTrueshotAuraTalent=Gain Attack Damage aura
TyrandeIcebladeArrows=Gain Attack Speed, reduce enemy damage dealt
TyrandeKaldoreiResistance=Light of Elune grants Spell Armor
TyrandeLightOfElune=Heal an allied Hero
TyrandeLightOfEluneCelestialAttunementTalent=Light of Elune removes Stuns and Silences
TyrandeLightOfEluneOverflowingLightTalent=Increase Light of Elune healing at high Health
TyrandeLightOfEluneQuickeningBlessingTalent=Light of Elune increases Movement Speed
TyrandeLightofEluneTalentCelestialAttunementToken=Light of Elune removes stuns
TyrandeLunarFlare=Stun and damage enemies in an area
TyrandeLunarFlareLunarBlazeTalent=<c val="#TooltipQuest">Quest:</c> Hit Heroes to empower Lunar Flare
TyrandeLunarFlareLunarBlazeTalentToken=Hit Heroes
TyrandeLunarFlareShootingStarTalent=Lunar Flare deals extra damage and refunds Mana on hit
TyrandeMoonlitArrows=Increase Light of Elune cooldown reduction
TyrandeRangerToken=Increased Sentinel damage
TyrandeRangersMark=Basic Attacks reduce Hunter's Mark cooldown
TyrandeSentinel=Fire a scouting Owl that reveals and damages enemy Heroes
TyrandeSentinelEmpowerTalent=Hitting Heroes reduces Sentinel cooldown
TyrandeSentinelPierceTalent=Sentinel hits multiple targets
TyrandeSentinelPierceToken=Increased Sentinel damage and targets hit
TyrandeSentinelRangerTalent=<c val="#TooltipQuest">Quest:</c> Distance increases Sentinel damage
TyrandeShadowstalk=Stealth and gain Movement Speed
TyrandeShadowstalkHuntersSwiftnessTalent=Allies gain Movement Speed 
TyrandeShootingStar=Basic Attacks periodically cast Lunar Flare
TyrandeShootingStarTalentToken=Periodically fire Lunar Flares
TyrandeStarfall=Damages and slows enemies in an area
TyrandeStarfallCelestialWrathTalent=Starfall applies Hunter's Mark to Heroes
UtherBeaconOfLight=Increase Holy Light self-healing
UtherBenedictionHotbar=Reduce Mana cost, cooldown of next ability
UtherDevotionEternalVanguardShop=Uther's healing grants Armor, and when killed his spirit remains
UtherDivineShield=Give ally Invulnerable and increased Move Speed<n/>
UtherDivineShieldBulwarkOfLightTalent=Increase Divine Shield duration, reduce cooldown
UtherDivineStorm=Damage and stun nearby enemies<n/>
UtherDivineStormDivineHurricaneTalent=Increase Divine Storm radius, reduce cooldown
UtherEternalDevotion=Uther's healing grants Armor, and when killed his spirit remains
UtherEternalDevotionArmorOfFaithTalent=Holy Light recharges faster while disabled
UtherEternalDevotionBlessedChampionTalent=Holy Light makes Basic Attacks heal
UtherEternalDevotionDivineProtectionTalent=Devotion stacks twice
UtherEternalDevotionGuardianOfAncientKingsTalent=Increase Devotion's Armor on disabled targets
UtherEternalDevotionHammerOfTheLightbringerTalent=<c val="#TooltipQuest">Quest:</c> Reduce Hammer of Justice cooldown
UtherFlashofLight=None
UtherHammerOfJusticePursuitOfJusticeTalent=Hammer of Justice grants Move Speed
UtherHammerOfJusticeWellMetTalent=Hammer of Justice weakens enemies
UtherHammerofJustice=Stun and damage an enemy
UtherHandOfProtection=Make an ally Unstoppable
UtherHolyFireTalent=Deals damage to nearby enemies
UtherHolyLight=Heal an ally and Uther
UtherHolyLightHolyShockTalent=Holy Light can deal damage
UtherHolyLightReachTalent=Increases Holy Light and Flash of Light range
UtherHolyLightSilverTouch=<c val="#TooltipQuest">Quest:</c> Mitigate damage to improve Holy Light
UtherHolyRadiance=Heal allies and damage enemies in a line
UtherHolyRadianceGatheringRadianceTalent=Holy Radiance gains power with more targets hit
UtherHolyRadianceGatheringRadianceTalentToken=Holy Radiance gains power with more targets hit
UtherHolyRadianceTyrsDeliveranceTalent=Holy Radiance increases healing received
UtherHolyRadianceWaveofLightTalent=<c val="#TooltipQuest">Quest:</c> Holy Radiance increases Devotion duration
UtherRedemptionTalent=Resurrect after Eternal Vanguard ends
UtherRighteousDefense=Holy Light grants Armor
ValeeraAdrenalineRush=Smoke Bomb increases Energy regeneration
ValeeraAmbush=Damage an enemy and reduce their Armor
ValeeraAssassinate=Ambush deals more damage to isolated Heroes
ValeeraBladeFlurry=Damage nearby enemies
ValeeraBlind=Increase Cheap Shot Blind duration
ValeeraCheapShot=Stun, Blind, and damage an enemy
ValeeraCloakOfShadows=Become Unstoppable, gain Spell Armor
ValeeraColdBlood=Activate to increase Eviscerate damage
ValeeraCombatReadiness=Spending Combo Points grants Block
ValeeraCripplingPoison=Spell Damage slows enemies
ValeeraCripplingPoisonBuffBar=Spell Damage slows enemies
ValeeraDeathFromAbove=Ambush can reduce Vanish cooldown
ValeeraElusiveness=Increases Vanish Movement Speed bonus
ValeeraEnvelopingShadows=Vanish grants Cloak of Shadows
ValeeraEviscerate=High damage finishing move
ValeeraExposeArmor=Eviscerate lowers target's Armor
ValeeraFatalFinesse=<c val="#TooltipQuest">Quest:</c> Hit Heroes with Blade Flurry
ValeeraGarrote=Deal high damage over time to an enemy
ValeeraHemorrhage=Garrote increases Basic Attack damage
ValeeraInitiative=Stealth Abilities award more Combo Points
ValeeraMutilate=Increases Sinister Strike damage but reduces range
ValeeraNightslayer=Reduces Vanish cooldown
ValeeraRelentlessStrikes=Reduces Sinister Strike Energy cost
ValeeraRupture=Increase Garrote damage over time
ValeeraSealFate=Empower Sinister Strike damage, Combo Points
ValeeraSinisterStrike=Dash forward, damaging enemies in a line
ValeeraSliceAndDice=Eviscerate grants Attack Speed
ValeeraSmokeBomb=Create an obscuring cloud of smoke
ValeeraStealth=Stealth and gain new Abilities
ValeeraStrangle=Garrote reduces Spell Power
ValeeraSubtlety=Stealth Abilities increase Energy regeneration
ValeeraThistleTea=Activate to instantly restore Energy
ValeeraVigor=<c val="#TooltipQuest">Quest:</c> Regen Globes increase max Energy
ValeeraWoundPoison=Spell Damage reduces enemy healing received
ValeeraWoundPoisonBuffBar=Spell Damage reduces enemy healing received
VarainVictoryRush=Basic Attacks periodically heal a lot
VarianBannerOfDalaran=Banner that grants Spell Power
VarianBannerOfIronforge=Banner that grants Armor
VarianBannerOfStormwind=Banner that grants Movement Speed
VarianBannersGloryToTheAlliance=Banner also increases healing effects
VarianCharge=Charge to an enemy and damage them
VarianChargeJuggernaut=Increase Charge damage
VarianChargeWarbringer=Reduce Charge cooldown, can be used on allies
VarianColossusSmash=Gain Damage, Lose Health</n>Smash enemies and lower their Armor
VarianColossusSmashMasterAtArms=Colossus Smash hits enemies near the target
VarianDemoralizingShout=Reduce damage of nearby Heroes
VarianHeroicStrike=Deal bonus damage on next Basic Attack
VarianHeroicStrikeActive=Bonus Basic Attack damage
VarianHighKingsQuestQuest=<c val="#TooltipQuest">Quest:</c>  Complete Quests to gain Attack Damage
VarianHighKingsQuestToken=<c val="#TooltipQuest">Quest:</c>  Complete Quests to gain Attack Damage
VarianHighKingsQuestTokenComplete=<c val="#TooltipQuest">Quest:</c>  Complete Quests to gain Attack Damage
VarianLionsFang=Damage and Slow enemies in a line and heal Varian
VarianLionsFangLionheart=Increase Lion's Fang healing
VarianLionsFangLionsMawQuest=<c val="#TooltipQuest">Quest:</c> Hit Heroes to empower Lion's Fang
VarianLionsFangLionsMawToken=<c val="#TooltipQuest">Quest:</c> Hit Heroes to empower Lion's Fang
VarianLionsFangLionsMawTokenComplete=<c val="#TooltipQuest">Quest:</c> Hit Heroes to empower Lion's Fang
VarianMortalStrike=Heroic Strike reduces enemy healing
VarianParry=Block incoming Basic Attacks for a short duration
VarianParryLionheart=Parry lasts longer, blocking reduces cooldown
VarianParryOverpower=Parrying a Hero's attack will refresh Heroic Strike
VarianParryShieldWall=Parry grants Protected
VarianSecondWind=Basic Attacks heal, more when low Health
VarianShatteringThrow=Deal massive damage to enemy Shields
VarianTaunt=Gain Health, Armor</n>Force a Hero to attack Varian
VarianTauntVigilance=Incoming attacks reduce Taunt cooldown
VarianTwinBladesOfFury=Gain Attack Speed, Lose Damage</n>Basic Attacks reduce Heroic Strike cooldown
VarianTwinBladesOfFuryFrenzy=Increase Twin Blades of Fury bonuses
VarianVictoryRush=Basic Attacks periodically grant a large heal
Windfury=Increases Attack and Movement Speed
WitchDoctorBigVoodoo=Increase Voodoo Ritual bonuses
WitchDoctorCorpseSpiders=Throw a jar that summons Spiders to attack enemies hit
WitchDoctorGargantuan=Summon a Gargantuan to guard an area
WitchDoctorGargantuanHumongoidTalent=Reduce Gargantuan cooldown and mana cost
WitchDoctorGargantuanStomp=None
WitchDoctorGuardianToads=Toads grant Armor
WitchDoctorHexedCrawlers=Corpse Spiders restore Health and Mana
WitchDoctorPandemic=<c val="#TooltipQuest">Quest:</c> Empower Plague of Toads
WitchDoctorPandemicToken=<c val="#TooltipQuest">Quest:</c> Hit Heroes with Toads to empower Plague of Toads
WitchDoctorPlagueOfToads=Summon a wave of exploding toads
WitchDoctorPlagueOfToadsToadsOfHugenessTalent=Toads become more powerful with each hop
WitchDoctorRavenousSpirit=Channel a damaging, movable spirit 
WitchDoctorRavenousSpiritAnnihilatingSpiritTalent=Increase range and speed of Ravenous Spirit
WitchDoctorRingOfPoison=Deals damage in center area
WitchDoctorSoulHarvest=Activate to increase Health and Spell Power
WitchDoctorSpiderColony=Corpse Spiders reduce other Basic Ability cooldowns
WitchDoctorSpiritofArachyr=More Corpse Spiders against single enemy
WitchDoctorSuperstition=Gain Spell Armor while not being Attacked
WitchDoctorThingOfTheDeepTalent=Increase the range of Nazeebo's Abilities
WitchDoctorToadAffinityTalent=Damage against heroes reduces cooldown
WitchDoctorVileInfection=<c val="#TooltipQuest">Quest:</c> Empower Voodoo Ritual
WitchDoctorVoodooRitualBloodRitualTalent=Voodoo Ritual restores Health and Mana
WitchDoctorVoodooRitualToken=Basic Attacks and Abilities deal damage over time. Killed minions increase Health and Mana.
WitchDoctorVoodooRitualTrait=Basic Attacks and Abilities deal damage over time. Killed minions increase Health and Mana.
WitchDoctorWidowmakers=<c val="#TooltipQuest">Quest:</c> Empower Corpse Spiders
WitchDoctorWidowmakersToken=<img path="@UI/StormTalentInTextQuestIcon" alignment="uppermiddle" color="B48E4C" width="20" height="22"/>Hitting Heroes empowers Corpse Spiders
WitchDoctorZombieWall=Summon a temporary ring of zombies that trap and attack
WitchDoctorZombieWallDeadRushTalent=Zombie Wall deals more damage and uproots
WitchDoctorZombieWallFreshCorpsesTalent=Reduces Zombie Wall cooldown
WizardAetherWalkerTalent=Teleport costs no Mana when out of combat
WizardArcaneOrb=Launch an orb that deals increasing damage the further it travels
WizardArcaneOrbArcaneOrbitTalent=Increases Arcane Orb range
WizardArcaneOrbArcaniteOrbTalent=Arcane Orb grows as it travels
WizardArcaneOrbObliterationTalent=Takedowns increase Arcane Orb's damage
WizardArcaneOrbPiercingOrbTalent=Arcane Orb now pierces
WizardArcaneOrbRansorsFollyTalent=Arcane Orb does even more damage from afar
WizardArcaneOrbTriumvirateTalent=Reduces Arcane Orb cooldown at max range
WizardArcaneOrbZeisVengeanceTalent=Arcane Orb does more damage from afar
WizardArchonPurePowerDisintegrate=Long range channeled beam
WizardArchonPurePowerHotbar=Use Disintegrate repeatedly, but no other Abilities
WizardArchonPurePowerHotbarCancel=Cancel Archon: Pure Power.
WizardAstralPresence=Increases Mana regen while low Mana
WizardCannoneerTalent=Abilities empower Basic Attacks
WizardDisintegrate=Long range channeled beam
WizardDisintegrateConvergenceTalent=Disintegrate does bonus damage if beam holds
WizardDisintegrateTemporalFluxTalent=Disintegrate slows enemies
WizardDominanceTalent=Takedowns restore Health
WizardEnergyArmor=More mana regen while low on mana
WizardFirebirdsFineryTalent=Resurrect if you would die
WizardFireflies=Magic Missiles move faster, lower cooldown and Mana cost
WizardForceArmorTalent=Magic Missiles grants Spell Armor
WizardGlassCannonTalent=Gain Spell Power but lose max Health
WizardMagicMissiles=Fire a volley of missiles
WizardMagicMissilesChargedBlastTalent=Magic Missiles marks enemies for bonus damage
WizardMagicMissilesMirrorballTalent=Fires 2 extra Magic Missiles and increases Mana cost
WizardMagicMissilesSeekerTalent=Increases Magic Missiles single-target damage
WizardPowerHungryTalent=Regen Globes give Spell Power and more Mana
WizardSpectralBladesTalent=Gain a stronger, melee Basic Attack
WizardSuperiorityTalent=Takedowns restore Mana
WizardTalRashasElementsTalent=Cycle abilities to gain Spell Power
WizardTeleport=Teleport a short distance
WizardTeleportCalamityTalent=Teleport deals damage
WizardTeleportDiamondSkinTalent=Teleport grants a Shield
WizardTeleportIllusionistTalent=Increases Teleport range, damage refreshes cooldown
WizardTeleportPrismTalent=Teleport makes your next Ability free
WizardTeleportWormholeTalent=Can cast Teleport twice
WizardTraitCriticalMass=Takedowns refresh Li-Ming's Ability cooldowns
WizardWaveOfForce=Damage and knock enemies back
WizardWaveOfForceMirrorMimics=Causes a cascade of Wave of Forces around you
WizardWaveOfForceRepulsionTalent=Increases cast range and knockback distance
ZagaraBanelingBarrage=Launch a Baneling that explodes on contact with an enemy
ZagaraBanelingBarrageBanelingMassacreTalent=Increases number of Banelings
ZagaraBanelingBarrageCentrifugalHooksTalent=Banelings can travel twice as far
ZagaraBanelingBarrageVolatileAcidTalent=Increase Baneling range and non-Hero damage
ZagaraCorrosiveSalivaHunterKillerTalent=Empowers Hunter Killers against Heroes
ZagaraCreepTumor=Generates Creep allowing Zagara and her minions to move faster
ZagaraCreepTumorEndlessCreepTalent=Increases Creep Tumor's cast range and duration
ZagaraCreepTumorMalignantTumorTalent=Decreased Creep Tumor cooldown, Mana cost removed
ZagaraCreepTumorMetabolicBoostTalent=Increased Movement Speed bonus on Creep
ZagaraCreepTumorProtectiveCoating=Gain Armor on Creep
ZagaraCreepTumorReconstitutionTalent=Increased Health Regeneration on Creep
ZagaraDevouringMaw=Eats enemies in area
ZagaraDevouringMawTyrantMawTalent=More damage and cooldown reduction from Takedowns
ZagaraEnvenomedSpinesTalent=Empower Zagara's next Basic Attack
ZagaraHunterKiller=Unleash a Hydralisk on an enemy
ZagaraHunterKillerBroodExpansionTalent=Reduces the cooldown of Hunter Killer
ZagaraHunterKillerGroovedSpinesTalent=Increased Hunter Killer range and damage
ZagaraHunterKillerMutaliskTalent=Hunter Killer summons a Mutalisk instead
ZagaraHydraliskTransfusionTalent=Hunter Killer attacks restore Health
ZagaraInfest=Increases nearby allied Ranged Minion's damage
ZagaraInfestItem=Increases nearby allied Ranged Minion's damage
ZagaraInfestedDrop=Bombard an area with a Zerg Drop Pod that spawns Roachlings
ZagaraInfestedDropBileDropTalent=<c val="#TooltipQuest">Quest:</c> Infested Drop impacts increase damage
ZagaraInfestedDropBileDropTalentToken=<c val="#TooltipQuest">Quest:</c> Infested Drop impacts increase damage
ZagaraInfestedDropCorpseFeedersTalent=Infested Drop cooldown is reduced and Roachlings take less damage
ZagaraMedusaBladesTalent=Basic Attacks hit 3 additional targets
ZagaraNydusNetwork=Empowers Creep and can create Nydus Worms
ZagaraSerratedSpines=<c val="#TooltipQuest">Quest:</c> Basic Attacks against Heroes increase damage
ZagaraViscousAcid=Banelings also slow enemies
ZaryaDefensiveShieldingTalent=Personal Barrier, Shield Ally grant Physical Armor
ZaryaEnergy=Damage absorbed by Zarya's Shields increase her damage.
ZaryaEnergyBornInBattleTalent=Reduces cooldowns at high Energy
ZaryaEnergyEnduranceTrainingTalent=Gain Armor at high Energy
ZaryaEnergyHitMeTalent=Shield damage absorbed contributes more Energy
ZaryaEnergyMaximumChargeTalent=Regen Globes grant Energy<n/><c val="#TooltipQuest">Quest</c>: Increases maximum Energy
ZaryaEnergyTogetherWeAreStrongTalent=Ally damage contributes to your Shields
ZaryaExpulsionZone=Launch a bomb that continually pushes enemies
ZaryaExpulsionZoneClearOutTalent=Increases Expulsion Zone radius and provides Energy
ZaryaGravitonSurge=Launch a gravity bomb that draws in enemies
ZaryaGravitonSurgeGravityKillsTalent=Graviton Surge has increased duration and deals damage
ZaryaPainIsTemporaryTalent=Consume Energy to gain a Shield
ZaryaParticleGrenade=Deals damage to enemies in a small area
ZaryaParticleGrenadeDemolitionsExpertComplete=<c val="#TooltipQuest">QUEST COMPLETE!</c><n/>Recharge rate is reduced and effect radius is increased
ZaryaParticleGrenadeDemolitionsExpertTalent=<c val="#TooltipQuest">Quest</c>: Increases Particle Grenade radius and reduces cooldown
ZaryaParticleGrenadeGrenadierTalent=Particle Grenade charges are returned at once
ZaryaParticleGrenadePinpointAccuracyTalent=Particle Grenade deals more damage in center area
ZaryaParticleGrenadePlasmaShockTalent=Particle Grenade slows enemies near the center
ZaryaPersonalBarrier=Gain a Shield that absorbs damage
ZaryaPersonalBarrierExplosiveBarrierTalent=Personal Barrier deals area damage
ZaryaPersonalBarrierIAmTheStrongestTalent=Increases Personal Barrier Shield amount
ZaryaPersonalBarrierSpellBarrierTalent=Personal Barrier grants Spell Armor
ZaryaPersonalBarrierUnstoppableCompetitorTalent=Personal Barrier grants Unstoppable
ZaryaShieldAlly=Grant an ally a Shield that absorbs damage
ZaryaShieldAllyCleansingShieldTalent=Shield Ally removes all disabling effects
ZaryaShieldAllyGainTrainTalent=Shield Ally now affects a second ally
ZaryaShieldAllyGiveMeTwentyCompleteTalent=<c val="#TooltipQuest">QUEST COMPLETE!</c><n/>Shield Ally Shield amount increased and cooldown permanently reduced
ZaryaShieldAllyGiveMeTwentyTalent=<c val="#TooltipQuest">Quest</c>: Increases Shield Ally absorb amount and reduces cooldown
ZaryaShieldAllySpeedBarrierTalent=Shield Ally increases allied Hero Movement Speed
ZaryaShieldAllyTogetherWeAreStrongTalent=Allied damage dealt with Shield Ally contributes to Energy
ZaryaUnyieldingDefenderTalent=Activate to reset Shield cooldowns
ZaryaWeaponFeelTheHeatTalent=Basic Attack deals more damage to close enemies
ZaryaWeaponToTheLimitTalent=Increases Basic Attack size at high Energy
ZeratulBlink=Teleport to a location. Ability does not break cloak
ZeratulBlinkMightoftheNerazim=Teleport to a location. Ability does not break cloak
ZeratulCleave=Damage nearby enemies
ZeratulCleaveGreaterCleaveTalent=Increases radius of Cleave
ZeratulCleaveMightoftheNerazim=Damage nearby enemies
ZeratulCleaveRendingCleaveTalent=Cleave deals additional damage over time
ZeratulComboSlash=Abilities increase Basic Attack damage
ZeratulDarknessDescends=Activate to gain Attack Speed
ZeratulGiftoftheXelNaga=Allies unaffected by Void Prison, enemies slowed
ZeratulGrimTaskTalent=<c val="#TooltipQuest">Quest:</c> Takedowns grant Spell Power
ZeratulMasterWarpBlade=Bonus damage every third Basic Attack
ZeratulMendingStrikes=Basic Attacks heal
ZeratulMightOfTheNerazimTalent=Recast last Basic Ability
ZeratulMoveUnseen=Gain Move Speed while Stealthed
ZeratulPermanentCloak=Become Stealthed while not attacking, using Abilities, or taking damage
ZeratulPsionicStrength=Basic Attacks, Abilities increase damage dealt
ZeratulSeekerInTheDark=Teleport to Singularity Spike target
ZeratulSentencedtoDeath=Deal bonus damage to marked targets
ZeratulShadowAssault=Basic Attacks teleport to enemies
ZeratulShadowHunter=<c val="#TooltipQuest">Quest:</c> Gather Regen Globes to empower Blink
ZeratulShadowHunterTokenButton=Teleport to a location. Ability does not break cloak
ZeratulShadowMending=Spell Damage dealt to Heroes heals
ZeratulShroudofAdun=Gain a shield while under Permanent Cloak
ZeratulSingularitySpike=Slow and damage the first enemy hit
ZeratulSingularitySpikeMightoftheNerazim=Slow and damage the first enemy hit
ZeratulSingularitySpikeShadowSpikeTalent=Increased Damage and explosion delay on Singularity Spike
ZeratulSlipintoShadow=Blink has 2 charges, but higher cooldown
ZeratulTwilightFalls=Might of the Nerazim resets cooldowns
ZeratulVoidPrison=Time Stop targets in an area
ZeratulVoidSlashTalent=Cleave empowered against multiple Heroes
ZeratulVorpalBladeHotbar=Teleport to last attacked enemy
ZeratulWarpSkirmisher=Vorpal Blade gains a charge
ZeratulWormholeTalent=Can return from Blink location
ZuljinAmaniRageTalent=Activate to lose Health and restore it over time
ZuljinAmaniResilience=Taz'dingo duration increased, restores Health
ZuljinArcaniteAxes=<c val="#TooltipQuest">Quest:</c> Increase Twin Cleave damage
ZuljinBerserker=Increased Attack Speed as Health gets lower
ZuljinBoneslicer=Empower Grievous Throw
ZuljinBuzzsaw=Guillotine keeps traveling forward
ZuljinEnsnare=Throw a net that Roots enemies
ZuljinEyeOfZuljin=Basic Attacks grant Move Speed
ZuljinFerocity=Increases Berserker's Attack Speed bonus
ZuljinForestMedicine=Regeneration cannot be interrupted
ZuljinGrievousAxe=
ZuljinGrievousThrow=Throw an Axe, damaging and marking a target, increasing Zul'jin's Basic Attack damage.
ZuljinGuillotine=Deal heavy area damage
ZuljinGuillotineFace=Guillotine's current damage
ZuljinHeadhunter=<c val="#TooltipQuest">Quest:</c> Takedowns increase damage
ZuljinLacerate=Increase Twin Cleave Slow
ZuljinLetTheKillingBegin=Killing enemies increases Attack Speed
ZuljinNoMercyTalent=Basic Attacks ignore Armor
ZuljinRecklessness=Low Health increases damage
ZuljinRegeneration=Zul'jin Channels to regenerate Health over time
ZuljinSwirlingDeath=Twin Cleave Axes keep spinning
ZuljinTazdingo=Become unkillable
ZuljinTrollsBlood=Regeneration heals more
ZuljinTwinCleave=Throw swirling Axes that Slow enemies
ZuljinViciousAssault=Increase Grievous Throw duration and damage
ZuljinVoodooShuffle=Activate to remove Roots and Slows
ZuljinWrongPlaceWrongTime=Bonus Twin Cleave damage at apex