AbathurDeepTunnel=Tunnel to a location.
AbathurEvolveMonstrosityHotbar=Minion or Locust becomes a powerful Monstrosity
AbathurLocustMasterHotbar=Create Locust Nests
AbathurLocustStrain=Spawn locusts that attack down the nearest lane
AbathurLocustStrainAssaultStrainTalent=Locusts cleave and explode
AbathurLocustStrainBombardStrainTalent=Locusts gain a ranged attack
AbathurLocustStrainSurvivalInstinctsTalent=Increases Locust Health and duration
AbathurLocustSwarm=Spawn a group of Locusts
AbathurMonstrosityEvolutionCompleteTalent=Monstrosity gains Deep Tunnel
AbathurSymbiote=Assist an ally and gain new abilities
AbathurSymbioteAdrenalOverloadTalent=Symbiote host gains Attack Speed
AbathurSymbioteAdrenalineBoostTalent=Carapace increases Move Speed
AbathurSymbioteCarapaceNetworkedCarapaceTalent=Carapace shields all nearby allies
AbathurSymbioteCarapaceSustainedCarapaceTalent=Increases Carapace shield and persists after Symbiote
AbathurSymbioteEnvenomedSpikesTalent=Spike Burst slows Move Speed
AbathurSymbioteHivemindTalent=Symbiote two targets
AbathurSymbioteNeedlespineTalent=Increases Stab damage and range
AbathurSymbiotePressurizedGlandsTalent=Increases Spike Burst range and decreases cooldown
AbathurSymbioteRegenerativeMicrobesTalent=Carapace heals target
AbathurSymbioteSpatialEfficiencyTalent=Stab gains an additional charge
AbathurSymbioteSpikeBurst=Damage nearby enemies
AbathurSymbioteSpikeBurstSomaTransferenceTalent=Spike Burst heals for each Hero hit
AbathurSymbioteStab=Shoots a spike that deals damage to the first enemy it contacts.
AbathurToxicNest=Spawn a mine
AbathurToxicNestBallistosporesTalent=Toxic Nests have global range and last longer
AbathurToxicNestEnvenomedNestTalent=Toxic Nests deal more damage
AbathurToxicNestProlificDispersalTalent=Increases Toxic Nest charges
AbathurToxicNestVileNestTalent=Toxic Nests slow Move Speed
AbathurUltimateEvolution=Clone target allied Hero and control it
AbathurUltimateEvolutionEvolutionaryLinkTalent=Ultimate Evolution target gets a Shield
AbathurVolatileMutationTalent=Heroic summons radiate damage
AlarakAppliedForce=Reduces Sadism to increase Telekinesis push distance
AlarakChaosReigns=<c val="#TooltipQuest">Quest:</c> Increases Discord Strike damage
AlarakCounterStrike2ndHeroic=Prevents damage to deal damage in a large area
AlarakCounterStrike2ndHeroicSadism=Deal increased ability damage to Heroes
AlarakCounterStrikeTargeted=Prevents damage to deal damage in a large area
AlarakCycleofDiscord=Reduces Discord Strike cooldown
AlarakDeadlyCharge=Channel to charge a long distance
AlarakDeadlyCharge2ndHeroic=Channel to charge a long distance
AlarakDeadlyCharge2ndHeroicSadism=Deal increased ability damage to Heroes
AlarakDiscordStrike=Damage and silence enemies in an area
AlarakDissonance=Reduces Sadism to increase Discord Strike silence duration
AlarakDoubleCross=Increases Discord Strike range and area
AlarakEndlessEnergy=<c val="#TooltipQuest">Quest: </c>Reduces Lightning Surge cooldown
AlarakExtendedLightning=Increases Lightning Surge range
AlarakHastyBargain=Activate to reduce Sadism bonus and reset Basic Ability cooldowns
AlarakHinderedMotion=Reduces Sadism to cause Telekinesis to slow
AlarakLastLaugh=Cleanse and teleport, but reduce Health
AlarakLightningSurge=Damage enemies in a line
AlarakNegativelyCharged=Increases Lightning Surge secondary target damage
AlarakPowerConduit=Reduces Lightning Surge Mana cost
AlarakProjectedForce=Reduces Sadism to increase Telekinesis range
AlarakPsychokinesis=Increases Telekinesis damage
AlarakPureMalice=Increases Sadism when Allies die
AlarakQuickMind=Reduces Sadism to reduce Telekinesis cooldown
AlarakRecklessStrike=Reduces Discord Strike delay but makes Alarak Vulnerable
AlarakSadism=Alarak deals increased Ability damage to Heroes
AlarakSustainingPower=Increases Lightning Surge healing
AlarakTelekinesis=Push enemies towards a location
AlarakThunderstruck=Reduces Sadism to cause Lightning Surge to slow
AlarakUnleashDeadlyCharge=Charge Recklessly
AlarakWideLightning=Increases Lightning Surge width
AlarakWithoutEffort=Removes Telekinesis Mana cost
AnubarakBeetleSpitBeetleJuiceTalent=Basic Attacks to Heroes spawn Beetles
AnubarakBurrowCharge=Burrow underground and charge in a direction
AnubarakBurrowChargeEpicenterTalent=Increases Burrow Charge area and reduces cooldown
AnubarakBurrowChargeUnderkingTalent=Increases Burrow Charge range and damage
AnubarakCarrionSwarm=Damages enemies and heals you
AnubarakCarrionSwarmHiveMasterTalent=Gain a permanent life-stealing Locust
AnubarakCocoon=Wraps enemy in a cocoon
AnubarakCryptweaveCocoonTalent=Increases Cocoon duration
AnubarakHardenCarapace=Gain a shield
AnubarakHardenCarapacePersistentCarapaceTalent=Longer lasting Shield
AnubarakHardenCarapaceSymbioticArmorTalent=Beetles get a Shield
AnubarakHardenCarapaceUrtricatingSpinesTalent=Harden Carapace deal area damage
AnubarakImpale=Shoot line of spikes that damages and stuns enemies
AnubarakImpaleBedOfBarbsTalent=Impale slows and damages over time
AnubarakImpaleExtendedSpikesTalent=Increases Impale range and damage
AnubarakLeechingMandiblesTalent=Beetles heal you
AnubarakLegionOfBeetlesTalent=Spawn Beetles periodically
AnubarakRegeneratingCarapaceChitinousPlatingTalent=Reduces Harden Carapace cooldown
AnubarakRegeneratingCarapaceLocustNeedlesTalent=Basic Attacks deal area damage
AnubarakRegeneratingCarapaceShedExoskeletonTalent=Harden Carapace increases Move Speed
AnubarakScarabHostAssaultScarabTalent=Beetles deal more damage
AnubarakScarabHostTrait=Spawn a Beetle whenever an Ability is cast
ArtanisBladeDash=Dash forward then back again, damaging enemies along the way
ArtanisBladeDashLethalAlacrityTalent=Increases the range and speed of Blade Dash
ArtanisBladeDashPsionicSynergyTalent=Blade Dash reduces Shield Overload cooldown
ArtanisBladeDashSolariteReaperTalent=Increases Blade Dash damage
ArtanisBladeDashTemplarsZealTalent=Blade Dash recharges faster when at low Health
ArtanisPhasePrism=Swap positions with an enemy Hero
ArtanisPhasePrismChronoSurgeTalent=Phase Prism grants Attack Speed
ArtanisPhasePrismGravitonVortexTalent=Reduces Phase Prism cooldown and pull another Hero
ArtanisPhasePrismKhaydarianResonanceTalent=Phase Prism refunds Mana and cooldown if you miss
ArtanisPhasePrismWarpSicknessTalent=Phase Prism slows enemies
ArtanisShieldOverloadForceofWillTalent=Increases Shield Overload Basic Attack reduction
ArtanisShieldOverloadPhaseBulwarkTalent=Shield Overload reduces incoming Ability Damage
ArtanisShieldOverloadShieldBatteryTalent=Reduces Shield Overload cooldown if it expires
ArtanisShieldOverloadShieldSurgeTalent=Shield Overload grants a burst of Shields
ArtanisShieldOverloadTrait=Gain a Shield when attacked at low Health
ArtanisSpearofAdunPurifierBeam=Chase an enemy with an orbital beam
ArtanisSpearofAdunPurifierBeamTargetPurifiedTalent=Purifier Beam recasts if target dies
ArtanisSpearofAdunSuppressionPulse=Damage and Blind enemies in a large area
ArtanisSpearofAdunSuppressionPulseOrbitalBombardmentTalent=Suppression Pulse gains an additional charge
ArtanisTwinBlades=You charge and Basic Attack twice
ArtanisTwinBladesAmateurOpponentTalent=Increases Twin Blades damage to non-Heroes
ArtanisTwinBladesPsionicWoundTalent=Twin Blades makes enemies take more damage
ArtanisTwinBladesReactiveParryTalent=Twin Blades gives Block
ArtanisTwinBladesTitanKillerTalent=Twin Blades deals more damage versus Heroes
ArtanisTwinBladesTripleStrikeTalent=Twin Blades strikes 3 times but increases cooldown
ArtanisTwinBladesZealotChargeTalent=Increase Twin Blades charge distance
ArthasAntiMagicShellTalent=Activate to reduce damage taken from Abilities
ArthasDeathlord=Reduces Death Coil cooldown and increases range
ArthasDeathsAdvanceTalent=Activate to increase Movement Speed
ArthasFrigidWindsFrozenTempestTalent=Frozen Tempest reduces enemy Attack Speed
ArthasIceboundFortitudeTalent=Activate to reduce damage taken and the duration of disabling effects
ArthasRemorselessWinterFrozenTempestTalent=Frozen Tempest can root enemy Heroes
ArthasAbsoluteZeroSummonSindragosaTalent=Increases Sindragosa range and disable duration
ArthasArmyOfTheDead=Raise ghouls that fight enemies or heal you
ArthasArmyOfTheDeadSacrifice=Sacrifice a Ghoul to heal yourself
ArthasBitingColdFrozenTempestTalent=Frozen Tempest damage increased
ArthasDeathCoil=Deals damage to a target or heals you
ArthasEmbraceDeathDeathCoilTalent=Death Coil deals more damage when missing Health
ArthasEternalHungerFrostmourneHungersTalent=<c val="#TooltipQuest">Quest:</c> Empower Frostmourne Hungers
ArthasFrostPresenceHowlingBlastTalent=Reduces Howling Blast cooldown against Heroes
ArthasFrostStrikeFrostmourneHungersTalent=Reduces Frostmourne Hungers cooldown and adds slow
ArthasFrostmourneFeedsFrostmourneHungersTalents=Increases number of Frostmourne Hungers attacks
ArthasFrostmourneHungers=Activate to empower your next attack and restore Mana on hit
ArthasFrozenTempest=Damage and slow nearby enemies. Drains Mana while active
ArthasFrozenWastesFrozenTempestTalent=Frozen Tempest Mana cost reduced
ArthasHowlingBlast=Root and damage enemies in an area
ArthasImmortalCoilDeathCoilTalent=Death Coil always heals
ArthasLegionOfNorthrendArmyOfTheDeadTalent=Ghouls last longer and more are created
ArthasRuneTapTalent=Consecutive Basic Attacks heal you
ArthasSummonSindragosa=Disables enemies and Structures
ArthasTrailOfFrostHowlingBlastTalent=Increases Howling Blast range and roots on the way
Attack=Damage enemies with Basic Attacks
AurielAngelicFlightTalent=Allows Auriel to fly to a chosen location
AurielBestowHope=Bestowed ally's damage contributes to your Ray of Heaven
AurielBlindingFlashSacredSweepTalent=Sacred Sweep blinds enemies in the center
AurielBurstingLightRayOfHeavenTalent=Reduces the cooldown of Ray of Heaven
AurielConvergingForceSacredSweepTalent=Sacred Sweep pushes enemies towards the center
AurielDetainmentStrike=Knock an enemy Hero back, stunning them if they collide with terrain
AurielDiamondResolveCrystalAegisTalent=Crystal Aegis grants allies a Shield
AurielEmpathicLinkBestowHopeTalent=Allied damage taken grants energy
AurielEnergizedCordRayOfHeavenTalent=Increases energy from Auriel Basic Attacks
AurielGlimmerofHopeRayOfHeavenTalent=Regen Globes reduce Ray of Heaven energy cost
AurielHeavyBurdenDetainmentStrikeTalent=Detainment Strike slows enemies after stun
AurielIncreasingClaritySacredSweepTalent=<c val="#TooltipQuest">Quest:</c> Increases center damage by hitting Heroes
AurielLightSpeedResurrectTalent=Resurrected ally is fully healed and moves faster
AurielMajesticSpanSacredSweepTalent=Increases Sacred Sweep radius
AurielPiercingLashDetainmentStrikeTalent=Detainment Strike hits all enemy Heroes in a line
AurielRayOfHeaven=Spend all energy to heal allied Heroes in an area
AurielRepeatedOffenseDetainmentStrikeTalent=<c val="#TooltipQuest">Quest:</c> Increases damage when Heroes are stunned
AurielRepellingStrikeDetainmentStrikeTalent=Detainment Strike knocks enemies away farther
AurielReservoirofHopeRayOfHeavenTalent=<c val="#TooltipQuest">Quest:</c> Increases maximum Ray of Heaven energy
AurielResurrect=Bring an allied Hero back to life
AurielRibbonFlight=Pull yourself to a point beyond targetted ally
AurielRighteousAssaultSacredSweepTalent=Hitting Heroes in the center reduces Sacred Sweep cooldown
AurielSacredSweep=Damages enemies in an a wide arc, bonus damage to enemies in the center
AurielSearingLightRayOfHeavenTalent=Ray of Heaven also damages enemies in the area
AurielShieldOfHopeTalent=Shield nearby allies based on their missing health
AurielSwiftSweepSacredSweepTalent=Increases Sacred Sweep cast speed
AurielWillofHeavenBestowHopeTalent=Bestow Hope ally gains Attack Speed
AurielWrathofHeavenBestowHopeTalent=Bestow Hope ally gains Ability Power
AurielCrystalAegis=Put an allied Hero into a Stasis crystal that explodes
AzmodanAllShallBurn=Channel a death beam on an enemy
AzmodanAllShallBurnGluttonyTalent=Damage heals Azmodan
AzmodanAllShallBurnMarchOfSinTalent=Can move during All Shall Burn
AzmodanAllShallBurnMasterOfDestructionTalent=Reduces All Shall Burn Mana cost and increased Range
AzmodanBlackPool=Create an empowering zone
AzmodanBlackPoolFifthCircleTalent=Black Pool gives slowing attacks
AzmodanDemonicInvasion=Damage area and create an army of Grunts
AzmodanDemonicInvasionPerishingFlameTalent=Demonic Grunts explode on death
AzmodanGeneralOfHell=Azmodan summons a Demon Lieutenant to assist Minions, Mercenaries, and Summons
AzmodanGeneralOfHellBoundMinionTalent=General of Hell improves a Minion
AzmodanGeneralOfHellDemonicSmiteTalent=Demon Lieutenants cast Demonic Smite
AzmodanGeneralOfHellForcedRecruitmentTalent=Reduces General of Hell cooldown, gains a charge
AzmodanGlobOfAnnihilationBattlebornTalent=Globe of Annihilation summons a Demon Warrior
AzmodanGlobeOfAnnihilation=Launch a long range orb of destruction dealing area damage
AzmodanGlobeOfAnnihilationHedonismTalent=Reduces Globe of Annihilation Mana cost
AzmodanGlobeOfAnnihilationInfernalGlobeTalent=Reduces cast time and increases missile speed
AzmodanGlobeOfAnnihilationSiegingWrathTalent=<c val="#TooltipQuest">Quest:</c> Hitting Heroes empowers Globe of Annihilation
AzmodanGlobeOfAnnihilationTasteForBloodTalent=<c val="#TooltipQuest">Quest:</c> Kills increase Globe of Annihilation damage
AzmodanGlobeOfAnnihilationTasteforBloodQuestToken=<c val="#TooltipQuest">Quest:</c> Kills increase Globe of Annihilation damage
AzmodanGlobeOfAnnihilationTasteforBloodQuestTokenComplete=<c val="#TooltipQuest">Quest:</c> Kills increase Globe of Annihilation damage
AzmodanGluttonousWardHotbar=Place a ward that restores your Health and Mana
AzmodanInfusedPowerTalent=All Shall Burn gains charge level
AzmodanSinforSin=Activate to steal Health from your target
AzmodanSinsGraspHotbar=Activate to deal damage over time
AzmodanSummonDemonWarrior=Summon a Demon Warrior
AzmodanSummonDemonWarriorArmyOfHellTalent=Increases Demon Warrior damage, decreases Mana cost
AzmodanSummonDemonWarriorHellforgedArmorTalent=Demon Warriors burn enemies and take less damage
BarbarianAncientSpear=Throw a spear and pull self to the first enemy hit, stunning and dealing damage
BarbarianAncientSpearCompositeSpearTalent=Increases Ancient Spear range and Fury generation
BarbarianAncientSpearMysticalSpearTalent=Reduces Ancient Spear cooldown and always pulls
BarbarianAncientSpearPoisonedSpearTalent=Increases Ancient Spear damage
BarbarianFury=Generate Fury in combat. All Abilities give you Move Speed
BarbarianFuryEndlessFuryTalent=Increases max Fury
BarbarianFuryFerociousHealing=Spend Fury to gain Health
BarbarianFuryNoEscapeTalent=Abilities give more Movement Speed
BarbarianFuryShotOfFuryTalent=Increases maximum Fury and can instantly gain more Fury
BarbarianFuryWarPaintTalent=Basic Attacks heal
BarbarianHurricaneWhirlwindTalent=Whirlwind removes slows and roots
BarbarianLeap=Jump to a location, deal damage, and stun enemies
BarbarianLeapArreatCraterTalent=Leap creates a crater and has reduced cooldown
BarbarianSeismicSlam=Damage an enemy and splash damage behind them
BarbarianSeismicSlamAftershockTalent=Using Seismic Slam temporarily reduces its Fury cost
BarbarianSeismicSlamFuriousBlowTalent=Increases Seismic Slam damage and cost
BarbarianSeismicSlamShatteredGroundTalent=Increases Seismic Slam splash
BarbarianWhirlwind=Damage nearby enemies and heal for a percentage of damage dealt
BarbarianWhirlwindLifeFunnelTalent=Increases Whirlwind healing
BarbarianWrathoftheBerserker=Increase damage and reduce disable duration
BarbarianWrathoftheBerserkerAngerManagementTalent=Increases Wrath Fury generation
BrightwingArcaneBarrageTalent=Increase Arcane Flare range
BrightwingArcaneFlare=Deals damage in an area. Deals greater damage to targets in the center
BrightwingArcaneFlareArcanePrecisionTalent=Increases Arcane Flare inner damage
BrightwingArcaneFlareStickyFlareTalent=Arcane Flare slows enemies
BrightwingBlinkHealAllyDash=Teleport to allies and heal them
BrightwingBouncyDustTalent=Pixie Dust bounces
BrightwingDoubleWyrmholeTalent=Free Blink Heal on second target
BrightwingDreamShotTalent=Reduces Arcane Flares cooldown for each Hero hit
BrightwingEmeraldWind=Damages and pushes enemies in area
BrightwingEmeraldWindContinuousWindsTalent=Emerald Wind gains two additional novas
BrightwingEmeraldWindSoothingMistAppender=Passively increases Soothing Mist healing
BrightwingGreaterPolymorphTalent=Increases Polymorph duration
BrightwingHyperShiftTalent=Soothing Mist reduces Phase Shift cooldown
BrightwingManicPixieTalent=Pixie Dust increases Soothing Mist healing
BrightwingMistifiedTalent=Basic Abilities reduce Soothing Mist cooldown
BrightwingPeekabooTalent=Phase Shift reveals large area
BrightwingPhaseShift=Teleport to an allied Hero
BrightwingPhaseShiftPhaseShieldTalent=Target gets a Shield upon arrival
BrightwingPixieBoostTalent=Pixie Dust grants an additional burst of speed
BrightwingPixieDust=Increases an ally's movement speed and blocks Basic Attacks
BrightwingPixieDustShieldDustTalent=Pixie Dust reduces Ability damage
BrightwingPolymorph=Disable an enemy
BrightwingPolymorphCritterizeTalent=Polymorph makes enemies Vulnerable
BrightwingRevitalizingMistTalent=Soothing Mist heals more subsequently
BrightwingSoothingMist=Brightwing passively heals nearby allied Heroes
BrightwingSoothingMistGustofHealing=Brightwing passively heals nearby allied Heroes
BrightwingUnfurlingSprayTalent=Increases Soothing Mist range
BrightwingUnstableAnomalyTalent=Polymorphed targets explode
ButcherButchersBrand=Brand an enemy, causing Basic Attacks to heal you
ButcherButchersBrandCraveFleshTalent=Butcher's Brand grants Move Speed
ButcherButchersBrandInsatiableBladeTalent=Increases Butcher's Brand healing and adds Movement Speed
ButcherCleaver=Basic Attacks deal area damage
ButcherEnragedTalent=Gain Attack Speed and reduce damage taken at low Health
ButcherFreshBloodFrenzyMeatTalent=Basic Attacks grant Attack and Move Speed
ButcherFreshMeat=Gather strength by killing enemies and collecting their meat
ButcherFreshMeatAbattoirTalent=Lose less Meat on death and grants additional Attack Damage
ButcherFreshMeatAbattoirToken=Gather strength by killing enemies and collecting their meat
ButcherFreshMeatAbattoirToken2=Gather strength by killing enemies and collecting their meat
ButcherFreshMeatToken=Gather strength by killing enemies and collecting their meat
ButcherFreshMeatTokenQuestComplete=Gather strength by killing enemies and collecting their meat
ButcherFreshMeatVictualsTalent=Nearby Minion deaths heal you
ButcherFurnaceBlast=Deal damage around you after a delay
ButcherFurnaceBlastFiresofHellTalent=Furnace Blast explodes twice
ButcherHamstring=Deals damage in an area and slows enemies
ButcherHamstringBrutalStrikeTalent=Hamstring empowers Basic Attacks
ButcherHamstringCheapShotTalent=Hamstring does bonus damage to movement-impaired targets
ButcherHamstringChopMeatTalent=Increases Hamstring damage to non-Heroes
ButcherHamstringCripplingSlamTalent=Hamstring slow no longer fades and lasts longer
ButcherHamstringFlailAxeTalent=Increases Hamstring length
ButcherHamstringInvigorationTalent=Reduces Hamstring Mana cost and cooldown on Heroes
ButcherLambToTheSlaughter=Chain an enemy Hero to a post
ButcherLambToTheSlaughterSlaughterhouseTalent=Lamb to the Slaughter chains all enemy Heroes
ButcherMeatShield=Ruthless Onslaught reduces Ability Damage taken
ButcherRuthlessOnslaught=Charges at an enemy, stunning and dealing damage
ButcherRuthlessOnslaughtFinalAssaultTalent=Increases Ruthless Onslaught range and adds lunge
ButcherRuthlessOnslaughtSavageChargeTalent=Ruthless Onslaught deals extra damage
ButcherRuthlessOnslaughtUnrelentingPursuitTalent=Reduces Ruthless Onslaught cooldown on impact
ChenAccumulatingFlame=<c val="#TooltipQuest">Quest:</c> Hit Heroes to empower Breath of Fire
ChenAccumulatingFlameToken=<c val="#TooltipQuest">Quest:</c> Hit Heroes to empower Breath of Fire
ChenAccumulatingFlameTokenComplete=<c val="#TooltipQuest">Quest:</c> Hit Heroes to empower Breath of Fire
ChenAnotherRound=Keg Smash reduces Basic Ability cooldowns
ChenBreathOfFire=Breathe fire in target direction, dealing damage and igniting Brew-soaked enemies
ChenBreathOfFireRingOfFireTalent=Damage nearby enemies after using Breath of Fire
ChenElusiveBrawler=Activate to evade Basic Attacks
ChenElusiveBrawlerHotbar=Activate to evade all Basic Attacks
ChenFire=Increase Attack Speed
ChenFirePassive=Increase Attack Speed
ChenFlyingKick=Kick through target enemy
ChenFlyingKickDeadlyStrikeTalent=Increase Flying Kick damage and remove Brew cost
ChenFlyingKickPressurePointTalent=Flying Kick slows enemies
ChenFlyingLeap=Increased Range
ChenFortifyingBrew=Instead of Mana, power your abilities by drinking Brew. Gain a Shield while drinking
ChenFortifyingBrewBolderFlavorTalent=Fortifying Brew grants a large Shield immediately
ChenFortifyingBrewBrewmastersBalanceTalent=Gain bonuses based on current level of Brew
ChenFortifyingBrewEnoughToShareTalent=Fortifying Brew Shields allied Heroes
ChenFortifyingBrewGroundingBrewTalent=Fortifying Brew reduces Ability Damage
ChenFreshestIngredients=<c val="#TooltipQuest">Quest:</c> Regen Globes increase Health Regen
ChenFreshestIngredientsTalentToken=<c val="#TooltipQuest">Quest:</c> Regen Globes increase Health Regen
ChenFreshestIngredientsTalentTokenComplete=<c val="#TooltipQuest">Quest:</c> Regen Globes increase Health Regen
ChenKegSmash=Drench enemies in a nearby area with Brew, slowing them
ChenKegSmashATouchOfHoneyTalent=Increase Keg Smash slow
ChenKegSmashKegTossTalent=<c val="#TooltipQuest">Quest:</c> Hit Heroes to empower Keg Smash
ChenKegTossToken=<c val="#TooltipQuest">Quest:</c> Hit Heroes to empower Keg Smash
ChenKegTossTokenComplete=<c val="#TooltipQuest">Quest:</c> Hit Heroes to empower Keg Smash
ChenPurifyingBrew=Stuns and Silences reset Fortifying Brew cooldown
ChenRefreshingElixir=Healing effects greatly increased while drinking
ChenStorm=Increase Movement Speed
ChenStormEarthFire=Split into three elemental spirits
ChenStormEarthFireElementalConduitTalent=Increase spirit Health and empower their abilities
ChenStormstoutSecretRecipe=Basic Abilities heal you
ChenSwiftReflexesTalent=Periodically dodge Hero attacks
ChenWanderingKeg=Roll around in the barrel and knock away enemies
ChenWanderingKegUntappedPotentialTalent=Increase Move Speed and gain damage reduction
ChenWitheringFlames=Setting Heroes on fire reduces their Ability Power
ChoBlazingBulwarkTalent=Consuming Blaze reduces incoming Basic Attacks
ChoConsumingBlaze=Damage nearby enemies and heal yourself
ChoCripplingBlowTalent=Surging Fist massively slows enemies
ChoCthunsGiftTalent=Basic Attacks are now ranged, slow targets
ChoFavorOfTheOldGodsTalent=Upheaval grants Resistant
ChoFireEaterTalent=Basic Attacks against Consuming Blaze targets heal you
ChoFrenziedFistsTalent=Surging Fist increases Attack Speed
ChoFuelForTheFlameTalent=Regen Globes empower Consuming Blaze
ChoHammerOfTwilight=Empower Basic Attacks and gain a knockback
ChoIAMHurryingTalent=Hurry Up, Oaf! no longer fades and lasts longer
ChoPowerSurgeTalent=Reduces Surging Fist warmup and increases width
ChoRollbackTalent=Rune Bomb returns
ChoRuneBomb=Throw a Rune Bomb down a line. Gall can detonate it to do area damage
ChoRunedGauntletTalent=Rune Bomb empowers Basic Attacks
ChoRunicFeedbackTalent=Runic Blast reduces Runic Bomb cooldown
ChoSearedFleshTalent=Every third Basic Attack does bonus damage
ChoSurgeOfStaminaTalent=Surging Fist grants Resistant
ChoSurgingDashTalent=Increases Surging Fist range and speed
ChoSurgingFist=Wind up a big punch that will dash you in a direction knocking aside enemies
ChoSurgingFistExecute=Wind up a big punch that will dash you in a direction knocking aside enemies
ChoTalentMoltenBlock=Activate to become Invulnerable
ChoTwilightVeilTalent=Consuming Blaze reduces incoming Ability Damage
ChoTwoHeaded=You have a second head named Gall
ChoUpheaval=Reach out and pull your enemies in
ChoWillOfGallTalent=Gall can make you Unstoppable
ChromieBronzeTalons=Increases Basic Attack range and damage
ChromieDragon'sClaw=Increased Attack range, Empower Basic Attacks
ChromieDragonsBreath=Deal damage in an area
ChromieDragonsBreathDeepBreathing=<c val="#TooltipQuest">Quest:</c> Hitting Heroes empowers Dragon's Breath
ChromieDragonsBreathDragonsEye=Dragon’s Breath damages more in the center
ChromieDragonsBreathEnvelopingAssault=Increases the radius of Dragon’s Breath
ChromieDragonsBreathMobiusLoop=Reduces Dragon’s Breath Mana, cooldown, damage
ChromiePeerIntoTheFuture=Activate to reveal target area
ChromiePortBackToBaseByeBye=Reduces Hearthstone cast time
ChromieQuantumOverdrive=Activate to gain Ability Power
ChromieReachingThroughTime=Increases Sand Blast and Dragon’s Breath range
ChromieSandBlast=Fire a long range blast that damages an enemy
ChromieSandBlastCompoundingAether=<c val="#TooltipQuest">Quest:</c> Hitting Heroes empowers Sand Blast
ChromieSandBlastFastForward=Long range Sand Blasts reduce its cooldown
ChromieSandBlastPastAndFutureMe=Sand Blast is remembered and re-cast
ChromieSandBlastPiercingSands=Sand Blast hits two targets
ChromieSandBlastShiftingSands=Sand Blast increases Ability Power
ChromieSlowingSands=Create slowing area
ChromieSlowingSandsPocketOfTime=Removes Slowing Sands Mana cost and increases slow
ChromieTemporalLoop=Return an enemy Hero to a previous position
ChromieTemporalLoopLoophole=Temporal Loop now hits multiple Heroes
ChromieTimeOutCancel=Cancel Time Out.
ChromieTimeOutHotbar=Activate to become Invulnerable
ChromieTimeTrap=Place a trap that puts enemies in Stasis
ChromieTimeTrapAndorhalAnomaly=Increases Time Trap charges
ChromieTimeTrapChronoSickness=Reduces Time Trap cooldown and Mana cost and adds slow
ChromieTimewalkerTrait=Gain Talents earlier than everyone else
ChromieTimewalkersPursuit=<c val="#TooltipQuest">Quest:</c> Regen Globes increase Mana Regen
CrusaderBlessedShield=Bouncing shield that stuns
CrusaderBlessedShieldRadiatingFaithTalent=Increases Blessed Shield stun duration and targets hit
CrusaderCondemn=Pulls and damages nearby enemies
CrusaderCondemnBlessedHammerTalent=Condemn creates a spinning hammer
CrusaderCondemnConvictionTalent=Condemn increases Movement Speed
CrusaderCondemnKnightTakesPawnTalent=Increases Condemn effect versus Minions and Mercenaries
CrusaderEternalRetaliationTalent=Condemn cooldown reduced per enemy hit
CrusaderFallingSword=Jump to area damaging and knocking up enemies
CrusaderFallingSwordHeavensFuryTalent=Falling Sword bombards enemies with holy bolts
CrusaderIndestructableTalent=Gain a Shield instead of dying
CrusaderIronSkin=Becomes Unstoppable and gains a Shield
CrusaderIronSkinFanaticismTalent=Iron Skin causes damage taken to increase Movement Speed
CrusaderIronSkinHoldYourGroundTalent=Increases Iron Skin Shield, reduces cooldown when broken
CrusaderIronSkinReinforceTalent=Basic Abilities grant Block
CrusaderIronSkinTheCrusadeMarchesOnTalent=Abilities reduce the cooldown of Iron Skin
CrusaderLawsOfHope=Increases Health Regen, activate to burst heal
CrusaderPunish=Damage and slow enemies
CrusaderPunishRighteousSmashTalent=Punish restores Mana per enemy hit
CrusaderRoarTalent=Increases Punish damage
CrusaderShieldGlare=Damages and blinds enemies in a cone
CrusaderShieldGlareHolyRenewalTalent=Shield Glare heals for each Hero hit
CrusaderShieldGlareSinsExposedTalent=Shield Glare makes enemies take bonus damage
CrusaderSubdueTalent=Increases Punish slow and duration
DehakaAdaptation=Heal for a portion of damage taken
DehakaAdaptationChangeIsSurvivalTalent=Increases Adaptation healing and lowers cooldown
DehakaBrushstalker=Burrow to a bush on the Battleground.
DehakaBrushstalkerApexPredatorTalent=Reduces the cooldown and cast time of Brushstalker
DehakaBrushstalkerFerociousStalkerTalent=Brushstalker increases Move Speed
DehakaBurrow=Protect yourself by burrowing into the ground
DehakaBurrowImprovedBurrowTalent=While Burrowed you can move
DehakaBurrowTalentLurkerStrain=Burrow grants Stealth
DehakaBurrowTalentNumbingEruption=Burrow knocks enemies back and slows Move Speed
DehakaBurrowTalentRapidRegeneration=Burrow heals you
DehakaDarkSwarm=Damage nearby enemies
DehakaDarkSwarmTalentEnduringSwarm=Dark Swarm reduces damage from Abilities
DehakaDarkSwarmTalentPrimalAggression=Increases duration of Dark Swarm and does bonus damage to Minions and Mercs
DehakaDarkSwarmTalentSymbiosis=Reduces Dark Swarm cooldown when you hit Heroes
DehakaDarkSwarmWhirlingDervish=Halves duration of disables during Dark Swarm
DehakaDrag=Deal light damage and drag an enemy
DehakaDragAggressivePreservationTalent=Drag reduces the cooldown of Burrow
DehakaDragParasiticWoundTalent=Drag increases the damage enemies take
DehakaDragTalentConstriction=Increases Drag duration
DehakaDragTalentElongatedTongue=Increases Drag range
DehakaDragTalentFeedingFrenzy=Basic Attacks reduce Drag cooldown
DehakaDragTalentParalyzingEnzymes=Drag slows
DehakaDragWatchMeWhipTalent=If Drag misses reduce cooldown and refund mana
DehakaEssenceCollection=Collect and consume enemy Essence to heal
DehakaEssenceCollectionOneWhoCollectsTalent=Increases Essence from Minions
DehakaEssenceCollectionStore=Killing enemy Heroes or Minions stores Essence that will heal over time when activated
DehakaEssenceCollectionTalentEnhancedAgility=<c val="#TooltipQuest">Quest:</c> Collecting Essence increases Move Speed
DehakaEssenceCollectionTalentEssenceDevourer=<c val="#TooltipQuest">Quest:</c> Gather Regen Globes to increase max Essence
DehakaEssenceCollectionTalentHeroStalker=Increases Essence from Takedowns
DehakaEssenceCollectionTalentSwiftPursuit=Increases Move Speed in bushes
DehakaEssenceCollectionTalentTissueRegeneration=<c val="#TooltipQuest">Quest:</c> Collecting Essence increases Health Regen
DehakaIsolation=Silence, slow, and reduce vision of an enemy
DehakaIsolationTalentContagion=Isolation splashes to nearby Heroes
DemonHunterCreedoftheHunter=Increases Attack Speed<n/><c val="#TooltipQuest">Quest:</c> Attacking Heroes empowers Hatred
DemonHunterDeathDealer=Increases Vault Basic Attack damage bonus
DemonHunterFarflightQuiver=Increases Basic Attack range
DemonHunterGloom=Consume Hatred to reduce Ability Damage taken
DemonHunterGloomItem=Consume Hatred to reduce Ability Damage taken
DemonHunterHatred=Basic Attacks grant bonus Attack Damage and Move Speed temporarily
DemonHunterHatredHotPursuitTalent=Max Hatred increases Movement Speed and Mana Regen
DemonHunterHatredPunishmentTalent=Hatred increases Multishot damage
DemonHunterHatredRancorTalent=Hatred increases Attack Speed
DemonHunterHatredTemperedByDisciplineTalent=Max Hatred grants healing on Basic Attacks
DemonHunterHungeringArrow=Fire an arrow which seeks out and strikes multiple targets
DemonHunterHungeringArrowMonsterHunterTalent=Reduces Hungering Arrow Mana cost and increases non-Hero damage
DemonHunterHungeringArrowPuncturingArrowTalent=<c val="#TooltipQuest">Quest:</c> Hitting Heroes empowers Hungering Arrow
DemonHunterHungeringArrowSiphoningArrowTalent=Hungering Arrow returns damage as Health
DemonHunterManticore=Consecutive Basic Attacks against Heroes are empowered
DemonHunterMultishot=Damage enemies in an area
DemonHunterMultishotArsenalTalent=Multishot launches grenades
DemonHunterMultishotCompositeArrowsTalent=Increases range of Multishot
DemonHunterMultishotFrostShotTalent=Multishot slows enemies and has increased range
DemonHunterRainOfVengeance=Area attack that stuns enemies
DemonHunterRainOfVengeanceStormOfVengeanceTalent=Basic Attacks reduce Cooldown
DemonHunterSeethingHatred=Hatred stacks faster and lasts longer
DemonHunterStrafe=Unleashes a flurry of arrows at enemies
DemonHunterStrafeDeathSiphonTalent=Fires penetrating bolts and heals
DemonHunterVault=Dash to a location
DemonHunterVaultCaltropsTalent=Drop Caltrops while Vaulting <n/><c val="#TooltipQuest">Quest:</c> Maintain Hatred to empower Vault
DemonHunterVaultRepeatingArrowTalent=Vault refreshes Hungering Arrow
DemonHunterVaultTumbleTalent=Hold two charges of Vault
DiabloApocalypse=Stun all enemy Heroes
DiabloApocalypseDyingBreathTalent=Reduces Apocalypse cooldown and triggers on death
DiabloBlackSoulstone=Gather souls from enemies to gain Health and resurrect faster
DiabloBlackSoulstoneActivateable=Activate to gain Health over time
DiabloBlackSoulstoneDevilsDueTalent=Black Soulstone requires fewer Souls
DiabloBlackSoulstoneSoulCatcherTalent=Black Soulstone passively generates Souls
DiabloBlackSoulstoneSoulFeastTalent=Black Soulstone increases Health Regen
DiabloBlackSoulstoneSoulStealTalent=Increases Black Soulstone Health bonus
DiabloDiabolicalMomentum=Basic Attacks reduce Ability cooldowns
DiabloEssenceOfTheSlainTalent=Gain Health and Mana when nearby enemies die
DiabloFireStomp=Unleash fire waves in all directions
DiabloFireStompFirestormTalent=Fire Stomp waves return
DiabloFireStompRampageTalent=Fire Stomp increases Move Speed and Attack Damage
DiabloFirestompFireDevilTalent=Fire Stomp grants a damage aura
DiabloLifeLeechTalent=Basic Attacks deal extra damage and heal you
DiabloLightningBreath=Channeled spell that damages enemies
DiabloLightningBreathHellstormTalent=Lightning Breath lasts and reaches longer
DiabloLordOfTerror=Steal Health from nearby enemy Heroes
DiabloOverpower=Grab an enemy and slam them behind Diablo, stunning them and dealing damage
DiabloOverpowerContinuousOverpowerTalent=Overpower gains second charge
DiabloOverpowerDemonicStrengthTalent=Overpower also slows
DiabloOverpowerDominationTalent=Overpower reduces cooldown of Shadow Charge
DiabloShadowCharge=Charge to a target enemy and push them back
DiabloShadowChargeDevastatingChargeTalent=Shadow Charge grants Resistant
DiabloShadowChargeFromTheShadowsTalent=Increases Shadow Charge into walls stun duration
DiabloShadowChargeOverwhelmingForceTalent=Increases Shadow Charge range and knockback
DragonKnightBullRush=Deal damage to enemies and send them flying
DragonKnightFireBreath=Deals initial damage and burns the ground for a time
DryadAbolishMagicHotbar=Remove negative status effects from yourself and the target
DryadBlossomSwellTalent=Increases Noxious Blossom radius
DryadBoundlessStrideTalent=All Leaping Strike charges returned at once, can target allies
DryadChokingPollenTalent=Increases Noxious Blossom damage to enemies with Nature's Toxin
DryadCripplingSpores=Slow enemies afflicted by Nature's Toxin and extend duration
DryadCruelSporesTalent=Reduces Crippling Spores cooldown and Mana on Minions and Mercs
DryadDividingWispTalent=Relocating a Wisp creates a copy
DryadDryadsSwiftness=You move <c val="#TooltipNumbers">20%</c> faster by leaping short distances.
DryadForestsWrathTalent=Increases Thornwood Vine range and speed
DryadGallopingGaitTalent=Activate to increase Movement Speed
DryadGreaterSpellShieldTalent=Greatly reduces incoming Ability Damage
DryadGreaterSpellShieldTalentHotbar=Greatly reduces incoming Ability Damage
DryadGreaterSpellShieldTalentToggleOff=Greatly reduces incoming Ability Damage
DryadInvigoratingSporesTalent=Crippling Spores increases Basic Attack Speed
DryadLeapingStrike=Damages and leaps over an enemy
DryadLetThemWitherTalent=Increases Crippling Spores slow
DryadNaturalPerspectiveTalent=Nature's Toxin reveals enemies
DryadNaturesCullingTalent=Increases Nature's Toxin damage to non-Heroes
DryadNaturesToxin=Basic Attacks and damaging Abilities deal damage over time
DryadNimbleWispTalent=Increases Wisp Move Speed and vision
DryadNoxiousBlossom=Deals area damage
DryadPesteringBlossomTalent=Increases Noxious Blossom range
DryadPhotosynthesisTalent=Crippling Spores returns Mana
DryadSiphoningToxinTalent=Nature's Toxin heals you
DryadSkyboundWispTalent=Wisp sees over obstacles and reveals area on death
DryadSplinteredSpearTalent=Noxious Blossom causes Basic Attack to hit 4 targets
DryadStarWoodSpearTalent=Crippling Spores increases Basic Attack range
DryadThornwoodVine=Damages in a line
DryadTimelostWispTalent=Wisp costs no Mana and reduces cooldown
DryadUnfairAdvantageTalent=Increases Nature's Toxin damage to slowed Heroes
DryadWildVigorTalent=Crippling Spores increases Basic Attack damage
DryadWisp=Spawns a Wisp to scout
ETCBlockParty=Rockstar also grants Block
ETCBlockPartyToken=Rockstar also grants Block
ETCCrowdSurfer=Powerslide can go over terrain
ETCDoubleNeckedGuitarTalent=Increases width and speed of Powerslide
ETCEncoreTalent=Face Melt will knock enemies away a second time
ETCGuitarSoloAggressiveShreddingTalent=Basic Attacks reduce Guitar Solo cooldown
ETCHammeronTalent=Abilities increase Basic Attack damage
ETCJustKeepRockinTalent=Guitar Solo reduces disable durations
ETCMicCheckTalent=Reduces Face Melt cooldown when hitting multiple enemies
ETCPinballWizardTalent=Increases Face Melt damage after Powerslide
ETCProgRockTalent=<c val="#TooltipQuest">Quest:</c> Regen Globes empower Guitar Solo
ETCRollingLikeaStoneTalent=Increased range on Powerslide
ETCShowStopperTalent=Temporarily reduce damage taken
ETCSpeedMetalTalent=Move Speed is added to Rockstar 
ETCStageDiveCrowdPleaserTalent=Stage Dive impact area bigger, cooldown reduced
FaerieDragonPixieCharm=Heal Allies with Soothing Mist to bribe a Mercenary
FaerieDragonPixieCharmTalent=Heal Allies with Soothing Mist to bribe a Mercenary
FaerieDragonPixieCharmTalentToken=Heal Allies with Soothing Mist to bribe a Mercenary
FaerieDragonPixieCharmToken=Heal Allies with Soothing Mist to bribe a Mercenary
FalstadAerialMomentum=Basic Attacks reduce Ability cooldowns
FalstadBarrelRoll=Dash to a location and gain a temporary shield
FalstadBarrelRollAfterburnerTalent=Barrel Roll increases Move Speed
FalstadBarrelRollUpdraftTalent=Increases Barrel Roll range and Shield
FalstadChargedUpTalent=Increases Lightning Rod strikes and range
FalstadEpicMountTalent=Reduces Flight cooldown and delay
FalstadFlight=Instead of mounting, you can fly a great distance over terrain
FalstadFlowRiderTalent=Tailwind recharges Basic Abilities faster
FalstadFreeRollTalent=Barrel Roll costs no Mana
FalstadGatheringStormTalent=<c val="#TooltipQuest">Quest:</c> Hitting Heroes empowers Hammerang
FalstadHammerGainsTalent=Basic Attacks heal you
FalstadHammerTimeTalent=Attack slowed targets to stun them
FalstadHammerang=Throw out a Hammer that returns. Hammer slows and damages enemies
FalstadHammerangBOOMerangActive=Deal damage in a small area around the Hammer.
FalstadHammerangBOOMerangTalent=Activate Hammerang second time for more damage
FalstadHammerangCripplingHammerTalent=Increases Hammerang slow
FalstadHinterlandBlast=Long range damage beam
FalstadHinterlandBlastCalloftheWildhammerTalent=Increases Hinterland Blast range and damage
FalstadLightningRod=Deal damage to target enemy while staying close to them
FalstadMightyGust=Push away enemies and slow them
FalstadPowerThrowTalent=Hammerang travels farther and slows longer
FalstadSecretWeaponTalent=Increases Hammerang range and Basic Attack damage
FalstadStaticShieldTalent=Gain Shields after every Lightning Rod strike
FalstadTailwind=After not taking damage for a brief period, gain increased Movement Speed
FalstadTailwindAerieGustsTalent=Reduces Tailwind delay
FalstadThunderstrikesTalent=Lightning Rod deals increasing damage
FalstadWindTunnelTalent=Mighty Gust constantly knocks back
FalstadWingmanHotbar=Kill Minions to bribe a Mercenary and empower Lightning Rod
FalstadWingmanHotbarTalent=Kill Minions to bribe a Mercenary and empower Lightning Rod
FalstadWingmanTalentToken=Kill Minions to bribe a Mercenary and empower Lightning Rod
FalstadWingmanToken=Kill Minions to bribe a Mercenary and empower Lightning Rod
FuryoftheStormTalent=Basic Attacks chain to non-Heroes
GallBombsAwayTalent=Increases Cho Rune Bomb range
GallDarkDescentTalent=Increases Runic Blast damage with Takedowns
GallDoubleBackTalent=Dread Orb third bounce reversed
GallDoubleTroubleTalent=Shadowflame cooldown reduced against burning Heroes
GallDreadOrb=Lob a ball of energy that bounces three times, damaging enemies it hits
GallDreadShieldTalent=Dread Orb grants a Shield
GallEdgeOfMadnessTalent=Increases Shadowflame damage to nearby enemies
GallEyeofKilroggHotbar=Place an eye that grants vision
GallGiantScorcherTalent=Increases Shadowflame damage to Heroes
GallHurryUpOaf=Give Cho a massive Movement Speed boost
GallPsychoticBreakTalent=Increases Ability Power and cast after death
GallRisingDreadTalent=Dread Orb damage increases each bounce
GallRunicBlast=Detonate Cho's Rune Bomb, dealing area damage
GallRunicPersistenceTalent=Runic Blast does not destroy Rune Bomb
GallShadowboltVolley=Launch a barrage of Shadow Bolts
GallShadowboltVolleyShadowfuryTalent=Shadow Bolt Volley pierces
GallShadowflame=Blast enemies in a narrow line
GallShadowflareTalent=Increases Shadowflame width and slows targets
GallShoveHotbar=Nudge Cho a short distance
GallSpeedOfTwilightTalent=Dread Orb grants bonus Movement Speed
GallSpurredOnwardTalent=Damaging Heroes reduces Hurry Up, Oaf! cooldown
GallTheNetherCallsTalent=Increases Twisting Nether slow and damage
GallTheWillofGallHotbar=Activate to make Cho Unstoppable
GallTwilightNovaTalent=Dread Orb launches 2 extra bombs
GallTwistingNether=Slow and damage nearby enemies
GallTwoHeaded=Your head is attached to Cho
GenericAmplifiedHealingTalent=All healing effects increased
GenericArcanePowerHotbar=Increases Spell Damage and restores Mana
GenericBattleMomentumTalent=Basic Attacks decrease Ability cooldowns
GenericBerserkHotbar=Activate to increase Attack and Movement Speed
GenericBlockTalent=Periodically reduces incoming Basic Attacks
GenericBloodForBloodHotbar=Activate to steal Health from your target
GenericBoltoftheStormTalent=Activate to teleport a short distance
GenericBribe=Kill Minions to bribe a Mercenary
GenericBribeTalent=Kill Minions to bribe a Mercenary
GenericBurningRageTalent=Deals damage to nearby enemies
GenericCalldownMule=Activate to heal and rearm Structures
GenericClairvoyance=Activate to reveal target area and nearby enemies
GenericCleanse=Makes target ally Unstoppable
GenericConjurersPursuitTalent=<c val="#TooltipQuest">Quest:</c> Regen Globes increase Mana Regeneration
GenericDemolitionistTalent=Basic Attacks destroy ammo and deal extra damage to Structures
GenericEnvenomTalent=Activate to deal damage over time
GenericExecutionerTalent=Attacking disabled Heroes increases damage
GenericFirstAid=Activate to heal over time
GenericFirstAid2=Activate to heal over time
GenericFocusedAttackTalent=Periodically empower Basic Attacks against Heroes
GenericFollowThroughTalent=Abilities increase Basic Attack damage
GenericForwardMomentumTalent=Ghost Wolf attacks reduce Basic Ability cooldowns
GenericFuryoftheStormTalent=Basic Attacks deal damage to nearby enemies
GenericGatheringPowerTalent=<c val="#TooltipQuest">Quest:</c> Takedowns grant Ability Power
GenericGiantKiller=Empowers your Basic Attacks against Heroes
GenericHardenedFocusTalent=Faster cooldowns near full Health
GenericHealingWardTalent=Activate to place a ward which heals in an area
GenericIceBlockTalent=Activate to become Invulnerable
GenericImposingPresenceTalent=Activate to slow enemy Basic Attacks and Move Speed
GenericMercenaryLordTalent=Nearby Mercs are stronger and you take less damage from them
GenericOverdriveTalent=Activate to empower your Abilities for extra Mana
GenericPromote=Target Minion takes less and deals more damage
GenericProtectiveShield=Activate to shield an allied Hero
GenericRegenerationMasterTalent=<c val="#TooltipQuest">Quest:</c> Regen Globes increase Health Regen
GenericRelentlessTalent=Halves duration of disables
GenericRewindHotbar=Activate to reset cooldowns
GenericScoutingDrone=Reveals a large area, can be killed
GenericSearingAttacks=Activate to increase Basic Attack damage at the cost of Mana
GenericSeasonedMarksmanTalent=<c val="#TooltipQuest">Quest:</c> Kill enemies to empower Basic Attacks
GenericShrinkRayTalent=Activate to reduce an enemy Hero's damage
GenericSpellShieldTalent=Activate to reduce incoming Ability Damage
GenericSpellShieldTalentHotbar=Activate to reduce incoming Ability Damage
GenericSpellShieldTalentToggleOff=Activate to reduce incoming Ability Damage
GenericSprint=Activate to increase Move Speed
GenericStoneskin=Activate to gain a Shield
GenericStormShield=Activate to grant Shields to all nearby allies
GenericVigorousAssaultTalent=Basic Attacks heal you
GenericVigorousStrikeTalent=Basic Attacks heal you
GhostShipCannonBombard=Bombard enemies with cannon fire
GraveGolemBindingRoots=Damage and root enemies in an area
GraveGolemMegaStun=Damage and stun enemies in a large area
GreymaneAlphaKillerTalent=Increases Worgen Basic Attacks against Heroes
GreymaneDarkflight=Leap at an enemy and shapeshift into a Worgen
GreymaneDarkflightCyclicalNatureTalent=Hitting a Hero with Gilnean Cocktail reduces Darkflight's cooldown
GreymaneDarkflightRunningWildTalent=Increases Darkflight and Disengage range
GreymaneDarkflightThickSkinTalent=Darkflight gives Block
GreymaneDisengage=Roll away and transform into a Human
GreymaneDisengageEyesInTheDarkTalent=Disengage grants Stealth
GreymaneEagerWolf=Increases Inner Beast Attack Speed
GreymaneGilneanCocktail=Damage the first enemy hit and deal heavy damage behind them
GreymaneGilneanCocktailConcentratedBlastTalent=Empowers Gilnean Cocktail during Inner Beast
GreymaneGilneanCocktailDraughtOverflowTalent=Increases Gilnean Cocktail explosion length
GreymaneGilneanCocktailIncendiaryElixirTalent=<c val="#TooltipQuest">Quest:</c> Increases Gilnean Cocktail damage
GreymaneGilneanCocktailPerfectAimTalent=Increases Gilnean Cocktail's range and refunds Mana against Heroes
GreymaneGilneanCocktailScentedTinctureTalent=Gilnean Cocktail reveals Heroes
GreymaneGoForTheThroat=Eviscerate a Hero, refresh cooldown if they die
GreymaneHuntersBlunderbussTalent=<c val="#ColorCreamYellow">Human</c> Basic Attacks splash
GreymaneInnerBeast=Gain a massive Attack Speed boost, and keep it for as long as you keep attacking
GreymaneInnerBeastInsatiableTalent=Inner Beast causes Basic Attacks to restore Mana
GreymaneInnerBeastOnTheProwlTalent=Inner Beast increases Movement Speed
GreymaneInnerBeastViciousnessTalent=Increases Inner Beast duration, Abilities refresh
GreymaneInnerBeastWolfheartTalent=Basic Attacks lower Inner Beast cooldown
GreymaneMarkedForTheKill=Fire a bullet that makes a Hero Vulnerable
GreymaneMarkedForTheKillGilneanRouletteTalent=Marked for the Kill Vulnerability is refreshed by all damage
GreymaneMarkedForTheKillLeap=Shapeshift into a <c val="#ColorViolet">Worgen</c> and leap to the target of Marked for the Kill, dealing damage on impact.
GreymaneQuicksilverBulletsTalent=Increases Human Basic Attack range
GreymaneRazorSwipe=Swipe forward and damage enemies you pass through
GreymaneRazorSwipeUnfetteredAssaultTalent=Increases Razor Swipe range
GreymaneRazorSwipeVisceralAttacksTalent=Basic Attacks reduce Razor Swipe's cooldown
GreymaneRelentlessPredatorTalent=Worgen Form reduces duration of disables
GreymaneToothAndClawTalent=<c val="#ColorViolet">Worgen</c> form Basic Attacks cleave
GreymaneUnleashed=Go for the Throat gets more powerful free casts
GreymaneWizenedDuelistTalent=<c val="#TooltipQuest">Quest:</c> Takedowns increase Basic Attack damage
GreymaneWorgenForm=Able to shapeshift between a Human and a Worgen
GuldanCataclysm=Channel at the target area pulling enemies toward the center and dealing damage upon expiration.
GuldanChaoticEnergy=<c val="#TooltipQuest">Quest:</c> Gather Regen Globes to reduce Mana costs
GuldanConsumeSoul=Instantly kill an enemy Minion to heal
GuldanCorruption=Deals damage over time to enemies in the area
GuldanCorruptionCurseOfExhaustion=Corruption slows enemy Movement Speed
GuldanCorruptionDemonicSight=Corruption reveals enemies
GuldanCorruptionEchoedCorruption=<c val="#TooltipQuest">Quest:</c> Hit <c val="#TooltipNumbers">40</c> Heroes with Corruption to increase strikes
GuldanCorruptionRuinousAffliction=Corruption deals bonus damage
GuldanDarkBargain=Increases Death Respawn timer and Health
GuldanDemonicCircle=Summon a Demonic Circle that you can teleport to
GuldanDemonicCircleSummon=Summon Demonic Circle
GuldanDemonicCircleTeleport=Teleport to Demonic Circle
GuldanDrainLife=Drain Health from an enemy, dealing damage and healing Gul'dan
GuldanDrainLifeDevourTheFrail=Drain Life deals more damage to weakened enemies
GuldanDrainLifeHarvestLife=Increases healing from Drain Life
GuldanDrainLifeHealthFunnel=Killing enemies with Drain Life refreshes its cooldown
GuldanDrainLifeTalentGlyphofDrainLife=Increases the cast range of Drain Life
GuldanFear=Fear the first enemy hero hit
GuldanFelFlame=Release a wave of flame that damages enemies
GuldanFelFlameBoundByShadow=Fel Flame hits reduce the cooldown of Corruption
GuldanFelFlameFelArmor=Fel Flame grants Spell Shield
GuldanFelFlameRampantHellfire=Increases Fel Flame's damage
GuldanFelFlameTalentPursuitOfFlame=<c val="#TooltipQuest">Quest:</c> Hit <c val="#TooltipNumbers">40</c> Heroes to increase area
GuldanHealthstone=Activate to heal
GuldanHorrify=Deals damage and fears Heroes
GuldanHorrifyHaunt=Increases duration and makes enemies Vulnerable
GuldanLifeTap=Restore Mana at the cost of Health
GuldanLifeTapDarknessWithin=Gain Ability Power after using Life Tap
GuldanLifeTapHungerforPower=Gain Ability Power but reduce healing received
GuldanLifeTapImprovedLifeTap=Life Tap restores more Mana
GuldanRainOfDestruction=Summon a rain of meteors in an area
GuldanRainOfDestructionDeepImpact=Rain of Destruction slows enemy Movement Speed
GuldanSeedOfCorruption=Deals damage over time to the enemy hero. If they survive, you become afflicted by Seed of Corruption
GuldanSeedOfCorruptionHeroSelect=Deals damage over time to the enemy hero. If they survive, you become afflicted by Seed of Corruption
HardenedShieldTalent=Activate to gain a Shield
HeroGenericBribeToken=Heal Allies with Soothing Mist to bribe a Mercenary
HeroGenericRegenGlobe=Heals nearby Heroes when picked up
IllidanBetrayersThirst=Basic Attacks heal for part of the damage dealt and reduce your Ability cooldowns
IllidanBetrayersThirstHuntersOnslaughtTalent=Basic abilities that deal damage heal you
IllidanBetrayersThirstThirstingBladeTalent=Sweeping Strikes increases Betrayer's Thirst healing
IllidanBetrayersThirstThrillOfBattleTalent=Activate to double cooldown reduction
IllidanBladesOfAzzinoth=Activate to increase Basic Attack damage
IllidanDive=Dive and flip over an enemy
IllidanDiveFriendOrFoeTalent=Increases Dive range and can Dive to allies
IllidanDiveLungeTalent=Increased Dive range
IllidanDiveMarkedForDeathTalent=Repeated Dives deal extra damage
IllidanDiveRapidChaseTalent=Dive increases Move Speed
IllidanElusiveStrike=Sweeping Strikes reduces Evasion Cooldown
IllidanEvasion=Evade enemy Basic Attacks
IllidanEvasionReflexiveBlockTalent=Dive grants Block
IllidanEvasionShadowShieldTalent=Evasion grants a Shield
IllidanEvasionSixthSenseTalent=Evasion reduces Ability damage
IllidanFieryBrand=Consecutive Basic Attacks to Heroes are empowered
IllidanMetamorphosis=Damage area and increase max Health
IllidanMetamorphosisDemonicFormTalent=Demon form lasts forever, grants Attack Speed
IllidanNimbleDefender=Sweeping Strikes grants Resistant
IllidanSweepingStrike=Dash and damage enemies while gaining Basic Attack damage
IllidanSweepingStrikeBatteredAssaultTalent=Increases Sweeping Strike damage bonus
IllidanSweepingStrikeFelReachTalent=Increased range on Sweeping Strike
IllidanSweepingStrikeImmolationTalent=Sweeping Strike deals area damage
IllidanSweepingStrikeSecondSweepTalent=Can store 2 charges of Sweeping Strike
IllidanSweepingStrikeUnboundTalent=Sweeping Strike can go over walls with reduced cooldown
IllidanTheHunt=Charge a target from a very long range
IllidanTheHuntNowhereToHideTalent=Increases The Hunt range and reveal low Health Heroes
IllidanUnendingHatredSweekingStrikeBonus=Sweeping Strike does bonus damage
IllidanUnendingHatredTalent=<c val="#TooltipQuest">Quest:</c> Killing enemies grants Basic Attack damage
JainaBlizzard=Creates a storm of ice at target location, damaging and slowing enemies
JainaBlizzardSnowCrashTalent=Adds an additional wave
JainaBlizzardSnowstormTalent=Increases radius
JainaBlizzardStormFrontTalent=Increases cast range
JainaConeOfCold=Deal damage in a cone and Chill targets
JainaConeOfColdIceFloesTalent=Increases area and cooldown reduction
JainaConeOfColdNorthernExposureTalent=Increases enemy damage taken
JainaConeOfColdNumbingBlastTalent=Roots Chilled targets
JainaFrostbiteArcaneIntellectTalent=Damage to Chilled targets returns Mana
JainaFrostbiteDeepChillTalent=Increases slow amount
JainaFrostbiteFrostArmorTalent=Chill attackers and reduce Basic Attacks
JainaFrostbiteFrostbittenTalent=Increases damage bonus
JainaFrostbiteIceBarrierTalent=Ability damage dealt gives Jaina Shields
JainaFrostbiteLingeringChillTalent=Increases duration
JainaFrostbolt=Shoot a bolt that deals damage and Chills the target
JainaFrostboltFrostShardsTalent=Pierces first target
JainaFrostboltIceLanceTalent=Reduces cooldown on Chilled targets
JainaFrostboltWintersReachTalent=Increases range
JainaIcyVeinsHotbar=Reduces cooldowns and Mana costs
JainaImprovedIceBlockHotbar=Gain Invulnerability and Chill enemies
JainaRingOfFrost=Creates a ring that damages and roots enemies 
JainaRingOfFrostColdSnapTalent=Secondary frost explosion occurs
JainaSummonWaterElemental=Summons Water Elemental to fight for you
JainaSummonWaterElementalWintermuteTalent=Increases cast range and Elemental mimics Basic Abilities
JainaTraitFrostbite=Your Abilities Chill targets, slowing them and causing them to take more damage
JohannaBlessedMomentum=Basic Attacks reduce Ability cooldowns
KaelthasArcaneBarrier=Gain a Shield based on maximum Mana
KaelthasArcaneDynamo=Using Basic Abilities increases Ability Power
KaelthasBurnedFleshTalent=Empower Flamestrike against multiple Heroes
KaelthasFlamestrike=Deal damage in an area
KaelthasFlamestrikeConvectionTalent=<c val="#TooltipQuest">Quest:</c> Flamestrike hits increase damage
KaelthasFlamestrikeFuryOfTheSunwellTalent=Flamestrike explodes twice
KaelthasFlamethrowerTalent=Increases Flamestrike's range
KaelthasGravityCrushTalent=Gravity Lapse increases damage taken
KaelthasGravityLapse=Stun an enemy
KaelthasGravityLapseEnergyRoilTalent=Reduce Gravity Lapse cooldown on Heroes
KaelthasGravityLapseGravityThrowTalent=Increases Gravity Lapse stun duration
KaelthasGravityLapseNetherWindTalent=Increases Gravity Lapse range and restores Mana
KaelthasGravityLapseTriOptimalTalent=Gravity Lapse reduces Verdant Spheres' cooldown
KaelthasLivingBomb=Damage an enemy over time, eventually exploding in an area around them
KaelthasLivingBombBackdraftTalent=Living Bomb explosion slows enemies
KaelthasLivingBombChainBombTalent=Living Bomb explosion spreads Living Bomb
KaelthasLivingBombFissionBombTalent=Increases Living Bomb explosion radius
KaelthasLivingBombPyromaniacTalent=Living Bomb reduces Basic Ability cooldowns
KaelthasLivingBombSunKingsFury=Living Bomb deals more damage after spreading
KaelthasMakethemPayLivingBomb=Living Bomb explodes a second time
KaelthasManaAddictTalent=<c val="#TooltipQuest">Quest:</c> Regen Globes grant Arcane Barrier
KaelthasManaTapTalent=Verdant Spheres restores Mana
KaelthasPhoenix=Summon a Phoenix to burn enemies
KaelthasPhoenixRebirthTalent=Increases Phoenix duration and may retarget
KaelthasPyroblast=Blast an enemy with a big fireball
KaelthasPyroblastPresenceOfMindTalent=Increases Pyroblast radius and lowers cooldown
KaelthasSunfireEnchantmentTalent=Special attack on Verdant Spheres activation
KaelthasVerdantSpheres=Make your next Basic Ability more powerful
KaelthasVerdantSpheresFelInfusionTalent=Increases Ability Power and Verdant Spheres heal
--KaelthasMasterOfFlamesLivingBomb=Living Bomb spreads indefinitely
KaelthasMasterOfFlamesLivingBomb=Living Bomb spreads indefinitely
KaelthasVerdantSpheresTwinSpheresTalent=Verdant Spheres gains a second charge
KerriganAdaptationTalent=Ravage can jump to allies
KerriganAggressiveDefenseTalent=Increases Assimilation Shields gained
KerriganAssimilation=Gain a temporary Shield by attacking enemies
KerriganAssimilationDoubleStrikeTalent=Abilities empower Basic Attacks
KerriganAssimilationFuryOfTheSwarmTalent=Basic Attacks cleave
KerriganAssimilationLingeringEssenceTalent=Increases Assimilation Shield duration
KerriganAssimilationMasteryTalent=Assimilation lasts longer and increases Health and Mana regeneration
KerriganBladedMomentum=Basic Attacks reduce Ability cooldowns
KerriganEssenceForEssenceHotbar=Activate to steal Health from your target
KerriganImpalingBlades=Stun and damage enemies in an area
KerriganImpalingBladesBladeTorrentTalent=Increases Impaling Blades area
KerriganImpalingBladesImpalingSwarmTalent=Impaling Blades spawns <d ref="[d ref='Effect,ImpalingBladesZerglingOffsetCreatePersistent,PeriodCount' player='0'/]"/> Zerglings
KerriganImpalingBladesSharpenedBladesTalent=Impaling Blades deals more damage
KerriganMaelstrom=Persistently damage nearby enemies
KerriganMaelstromOmegastormTalent=Increased Maelstrom size and Shield generation
KerriganPrimalGrasp=Pull and damage enemies in an area
KerriganPrimalGraspEnergizingGraspTalent=Primal Grasp costs less Mana
KerriganPrimalGraspPsionicPulseTalent=Damage nearby enemies
KerriganQueensRushHotbar=Takedowns increase Move Speed
KerriganRavage=Leap to an enemy and deal damage
KerriganRavageCleanKillTalent=Ravage refunds Mana on kill and increases damage
KerriganRavageEviscerateTalent=Increases Ravage range
KerriganRavageSiphoningImpactTalent=Ravage heals Kerrigan
KerriganSummonUltralisk=Summon an Ultralisk to chase a target
KerriganSummonUltraliskTorrasqueTalent=Ultralisk spawns a new Ultralisk on death
KnightMagicVolley=Repeatedly deal Ability damage to enemies
L90ETCDeathMetalTalent=A ghost of you uses Mosh Pit when you die
L90ETCFaceMelt=Knock back and damage nearby enemies
L90ETCFaceMeltFaceSmeltTalent=Face Melt slows enemies
L90ETCFaceMeltLoudSpeakersTalent=Increases range and knockback of Face Melt
L90ETCGuitarSolo=Regenerate Health
L90ETCGuitarSoloGroupiesTalent=Guitar Solo heals nearby allied Heroes
L90ETCGuitarSoloGuitarHeroTalent=Basic Attacks heal you during Guitar Solo
L90ETCMoshPit=Nearby enemies must dance
L90ETCMoshPitTourBusTalent=Makes Powerslide usable during Mosh Pit
L90ETCPowerslide=Dash to an area, stunning and damaging enemies hit
L90ETCRockstar=After using an ability, E.T.C. and nearby allies temporarily gain Attack Speed
L90ETCRockstarEchoPedalTalent=Abilities cause area damage
L90ETCStageDive=Dive to a location and deal damage
LeoricBuriedAliveTalent=Entomb damages enemies
LeoricConsumeVitalityTalent=Skeletal Swing heals
LeoricCrushingHopeTalent=Drain Hope does bonus damage if it finishes
LeoricDeathMarchTalent=March of the Black King applies Drain Hope
LeoricDrainHope=Drain Health from an enemy Hero while close to them
LeoricDrainMomentumTalent=Drain Hope now grants Movement Speed
LeoricEntomb=Wall in an area
LeoricFealtyUntoDeathTalent=Gain Health and Mana when Minions die
LeoricGhastlyReachTalent=Longer Skeletal Swing range
LeoricHardenedBonesTalent=Take less damage during Wraith Walk
LeoricHopelessnessTalent=Increases Drain Hope range
LeoricLingeringApparitionTalent=Wraith Walk lasts longer
LeoricManaThirstTalent=Skeletal Swing restores Mana per enemy hit
LeoricMarchoftheBlackKing=Heal yourself while damaging nearby enemies
LeoricOsseinRenewalHotbar=Activate to heal, while alive or Undying
LeoricParalyzingRageTalent=Increased Skeletal Swing slow
LeoricReanimationTalent=<c val="#TooltipQuest">Quest:</c> Regen Globes revive you faster
LeoricRenewedSwingTalent=Can cast Skeletal Swing again
LeoricRoyalFocusTalent=Reduce Wraith Walk cooldown. Empowers Skeletal Swing
LeoricSkeletalSwing=Deal damage and slow in a cone in front of you
LeoricSpectralLeechTalent=Basic Attacks deal extra damage and heal you
LeoricUndyingTrait=Haunt your enemies as a ghost when you die
LeoricUnyieldingDespairTalent=Drain Hope cooldown is reduced
LeoricWillingVesselTalent=Increases Drain Hope healing
LeoricWraithWalk=Separate from your body and move unhindered
LiLiBlindingWind=Blind and damage nearby enemies
LiLiBlindingWindGaleForceTalent=Increases Blinding Wind damage
LiLiBlindingWindHinderingWindsTalent=Blinding Wind slows targets
LiLiBlindingWindLingeringBlindTalent=Increases the duration of Blinding Wind
LiLiBlindingWindMassVortexTalent=Blinding Wind hits more targets
LiLiCloudSerpent=Summon a serpent to assist an ally
LiLiCloudSerpentLightningSerpentTalent=Cloud Serpent's attacks bounce
LiLiCloudSerpentTimelessCreatureTalent=Increases Cloud Serpent duration
LiLiFastFeet=When struck by enemies, gain Movement Speed
LiLiFastFeetElusiveFeetTalent=Fast Feet gives Block charges
LiLiHealingBrew=Heal a nearby ally
LiLiHealingBrewTheGoodStuffTalent=Healing Brew also heals over time
LiLiHealingBrewTwoForOneTalent=Healing Brew heals twice but longer cooldown
LiLiJugof1000Cups=Rapidly heal nearby allies
LiLiJugof1000CupsJugof1000000CupsTalent=Throw out two cups at a time
LiLiKungFuHustleTalent=Cooldowns recharge faster when damaged
LiLiMendingSerpentTalent=Cloud Serpent heals each attack
LiLiPitchPerfectTalent=Repeated Healing Brews cost less Mana
LiLiProTossTalent=Increases Healing Brew range
LiLiSafetySprintTalent=Increases Fast Feet Move Speed
LiLiSerpentSidekickTalent=Also gives you a Cloud Serpent when cast on allies
LiLiShakeItOffTalent=Being Stunned or Rooted grants Resistant
LiLiSurgingWindsTalent=Gain Ability Power from Blinding Wind
LiLiWaterDragon=Damages and heavily slows nearest enemy Hero
LiLiWaterDragonDoubleDragonTalent=Summons two dragons
LostVikingSelectBaleog=<c val="#TooltipNumbers">Baleog</c> deals splash damage to enemies behind his attack target
LostVikingSelectErik=<c val="#TooltipNumbers">Erik</c> moves faster than the other Vikings and has a longer attack range
LostVikingSelectOlaf=<c val="#TooltipNumbers">Olaf</c> has lots of health, regenerates health quickly, and charges to slow enemies
LostVikingsBaleogTheFierceTalent=Baleog's attacks increase his Attack Speed
LostVikingsCheckpointReachedTalent=Additional revive and heal
LostVikingsErikTheSwiftTalent=Increases Erik's Move Speed and heal while running
LostVikingsExplosiveAttacksTalent=Increases Baleog splash to non-Heroic enemies
LostVikingsFuryoftheStormTalent=Basic Attacks chain to non-Heroes
LostVikingsGoGoGo=Gain <c val="#TooltipNumbers"><d ref="100*Behavior,LostVikingsGoGoGo,Modification.UnifiedMoveSpeedFactor"/>%</c> increased Movement Speed
LostVikingsGoGoGo64KBMarathonTalent=Run faster and break slows and roots
LostVikingsHunkaBurningOlafTalent=Olaf deals damage to nearby enemies
LostVikingsImpatienceIsAVirtueTalent=Vikings' attacks reduce cooldowns of all Vikings
LostVikingsItsASabotageTalent=Erik's attacks stronger against Structures
LostVikingsJump=Grants temporary Invulnerability
LostVikingsLargeAndInChargeTalent=Charge stuns enemies
LostVikingsLongboatRaid=Load into a Longboat to attack enemies
LostVikingsNordicAttackSquad=Increases Viking Basic Attacks to Heroes
LostVikingsNorseForce=All Vikings gain a Shield
LostVikingsOlafTheStoutTalent=Olaf blocks Basic Attacks
LostVikingsPainDontHurtTalent=Baleog's attacks heal himself
LostVikingsPlayAgain=Revive and summon Vikings
LostVikingsSpinToWin=Deals damage around each Viking
LostVikingsSpyGamesTalent=Erik gains Stealth and increases vision if stationary
LostVikingsTheSequelTalent=Reduces death timer for all Vikings
LostVikingsVikingBribery=Kill Minions to bribe a Mercenary
LostVikingsVikingBriberyToken=Kill Minions to bribe a Mercenary
LostVikingsVikingHoardHeroSelect=Gather Regen Globes to increase Health Regen
LostVikingsVikingHoardTalent=Gather Regen Globes to increase Health Regen
LostVikingsWereOnABoatTalent=Increased combat prowess
MalfurionEntanglingRoots=Root and damage enemies in an area
MalfurionEntanglingRootsStranglingVinesTalent=Increases Entangling Root damage
MalfurionEntanglingRootsTenaciousRootsTalent=Increases Entangling Root area and duration
MalfurionEntanglingRootsVengefulRootsTalent=Entangling Roots spawns a Treant
MalfurionInnervate=Grant Mana to an ally and reduce their cooldowns
MalfurionInnervateElunesGraceTalent=Increases Basic Ability ranges
MalfurionInnervateShandosClarityTalent=Reduces Innervate cooldown
MalfurionInnervateVersatileTalent=Increases Innervate Mana return
MalfurionMoonfire=Reveal and damage enemies in an area
MalfurionMoonfireFullMoonfireTalent=Increases Moonfire area and reduces Mana cost
MalfurionMoonfireHinderingMoonfireTalent=Moonfire slows targets
MalfurionMoonfireLunarShowerTalent=Successive Moonfires are more powerful
MalfurionMoonfireMoonburnTalent=Increases Moonfire damage to non-Heroic units
MalfurionRampantGrowthTalent=Increases initial heal of Regrowth
MalfurionRegrowth=Heal an ally or self over time
MalfurionRegrowthEnduringGrowthTalent=Increases Regrowth duration
MalfurionRegrowthHarmonyTalent=Moonfire reduces Mana cost of Regrowth
MalfurionRegrowthLifeSeedTalent=Nearby Heroes receive Regrowth periodically
MalfurionTranquility=Heals nearby allied Heroes over time
MalfurionTranquilitySerenityTalent=Increases Tranquility healing and grants Mana
MalfurionTwilightDream=Silence and damage nearby enemies<n/>
MalfurionTwilightDreamNightmareTalent=Increases Twilight Dream silence duration and adds slow
MedicAutomatedBlockTalent=Periodically reduces incoming Basic Attacks
MedicBioshieldTalent=Grants Shield at full Health
MedicCaduceusReactor=Restore Health when not taking damage
MedicCaduceusReactor2dot0Talent=Restores Mana and grants Shields
MedicClearTalent=Increased area, bigger knockback
MedicCouplesTherapyTalent=Healing Beam also heals you
MedicDetonateDisplacementGrenade=Damages and knocks enemies away
MedicDisplacementGrenade=Damages and knocks enemies away
MedicFeedbackLoopTalent=Safeguard returns Mana on expiration
MedicHealingBeam=Heals allies over time
MedicInfusedGrenadeTalent=Displacement Grenade refunds Mana on Hero impact
MedicInoculationTalent=Increases Safeguard initial damage reduction
MedicIntensiveCareTalent=Healing Beam's healing increases over time
MedicIrradiateTalent=Healing Beam grants damage aura
MedicMedbayTalent=Medivac heals nearby allies
MedicMedivacDropship=Transport allies across long distances
MedicPreventativeCareTalent=Healing Beam target reduces enemy Attack Speed
MedicProlongedSafeguardTalent=Increases Safeguard duration
MedicSafeguard=Grants Resistant to the target
MedicSecondOpinionTalent=Reduces Displacement Grenade cooldown, gains second charge
MedicShieldSequencerTalent=Safeguard can be cast twice
MedicStimDrone=Grant massive Attack and Movement Speed
MedicSystemShockTalent=Displacement Grenade slows on impact
MedicTransfusionTalent=Lasts longer, also affects self
MedicTraumaTriggerTalent=Safeguard automatically activates at low Health
MedicUpgradedBallisticsTalent=Increases Displacement Grenade speed and damage
MedivhArcaneBrilliance=Grant Ability Power and Mana to allies
MedivhArcaneRift=Launch an arcane bolt that damages enemies in a line
MedivhArcaneRiftArcaneCharge=Arcane Rift deals more damage after hitting a Hero
MedivhArcaneRiftGuardianOfTirisfal=Arcane Rift kills Minions instantly
MedivhArcaneRiftManaAdept=Increases Arcane Rift Mana refund
MedivhArcaneRiftTheMastersTouch=<c val="#TooltipQuest">Quest:</c> Hit <c val="#TooltipNumbers">30</c> Heroes to increase damage
MedivhDustOfAppearance=Reveal Heroes in the surrounding area
MedivhForceOfWill=Protect an allied Hero from damage
MedivhForceOfWillArcaneExplosion=Force of Will deals area damage
MedivhForceOfWillCircleOfProtection=Force of Will shields allies near the target
MedivhForceOfWillEnduringWill=Increases Force of Will duration
MedivhForceOfWillReabsorption=Force of Will heals the target
MedivhInvisibility=Stealth an allied Hero
MedivhLeyLineSeal=Unleash a wave that disables enemy Heroes
MedivhLeyLineSealMedivhCheats=Ley Line Seal can be redirected while active
MedivhPolyBomb=Polymorph a Hero that spreads to other Heroes
MedivhPolyBombGlyphOfPolyBomb=Poly Bomb spreads faster and farther
MedivhPortal=Create a portal that allies can pass through
MedivhPortalAstralProjection=Increases Portal range
MedivhPortalMageArmor=Using a Portal grants Block
MedivhPortalPortalMastery=Place both Portal locations
MedivhPortalQuickening=Reduces Portal cooldown
MedivhPortalRavenFamiliar=Using a Portal grants a Raven Familiar
MedivhPortalStablePortal=Increases Portal duration
MedivhRavenForm=Transform into a raven
MedivhTransformRaven=Transform into a raven
MedivhTransformRavenBirdsEyeView=Increases Raven Form vision range
MedivhTransformRavenRavensIntellect=Raven Form increases Mana Regen
MedivhTransformRavenWindsOfCelerity=Increases Raven Form Movement Speed
MonkBlankTrait=Choose a Trait
MonkBlazingFistsTalent=Basic Attacks reduce Deadly Reach cooldown
MonkBlindingSpeedTalent=Radiant Dash more often
MonkBreathOfHeaven=Heal nearby ally Heroes and grant Movement Speed
MonkBreathOfHeavenCircleOfLifeTalent=Increases Breath of Heaven healing per nearby ally
MonkDeadlyReach=Increases Attack Speed and Attack Range
MonkDivinePalm=Prevent an ally from death
MonkEchoofHeavenTalent=Breath of Heaven heals a second time
MonkElevenSidedStrikeTalent=Seven-Sided Strike hits more
MonkEpiphany=Activate to restore Mana and Radiant Dash charges
MonkFistsofFuryTalent=Increases Deadly Reach duration
MonkForesightTalent=Radiant Dash reveals the area
MonkInsightTalent=<c val="#TooltipQuest">Quest:</c> Basic Attacks restore mana, lower cooldowns
MonkIronFistsTalent=Basic Attacks deal bonus damage
MonkOvertakeTalent=Deadly Reach attacks increase Move Speed
MonkPeacefulReposeTalent=Reduces Divine Palm cooldown if they do not die
MonkQuicksilverTalent=Radiant Dash gives Move Speed
MonkRadiantDash=Jump to an ally or enemy
MonkSevenSidedStrike=Become Invulnerable and strike nearby Heroes
MonkSixthSense=Stuns and Roots reduce incoming Basic Attacks
MonkSoothingBreezeTalent=Breath of Heaven removes silences, blinds, slows and roots
MonkTranscendenceTalent=Basic Attacks heal
MonkWayoftheHundredFistsTalent=Radiant Dash launches a volley of blows
MuradinAvatar=Temporary Health boost
MuradinAvatarUnstoppableForceTalent=Increases Avatar duration and reduces disables
MuradinDwarfToss=Leap to an area, dealing damage to nearby enemies
MuradinDwarfTossDwarfLaunchTalent=Increases Dwarf Toss range and impact
MuradinDwarfTossHeavyImpactTalent=Dwarf Toss briefly stuns enemies hit
MuradinDwarfTossLandingMomentumTalent=Dwarf Toss increases Move Speed
MuradinGiveEmTheAxeTalent=Attacking disabled Heroes increases damage
MuradinHaymaker=Stun and knock an enemy away
MuradinHaymakerGrandSlamTalent=Increases Haymaker damage and adds charge
MuradinIronforgedMomentum=Basic Attacks reduce Ability cooldowns
MuradinSecondWind=Restore Health when not taking damage
MuradinSecondWindSkullcrackerTalent=Successive Basic Attacks will stun a target
MuradinSecondWindStoneformTalent=Activate to heal over time
MuradinSecondWindThirdWindTalent=Increases Second Wind's healing
MuradinStormbolt=Throw a hammer, stunning and damaging the first enemy hit
MuradinStormboltInfusedHammerTalent=Refunds Mana if it hits an enemy
MuradinStormboltPerfectStormTalent=<c val="#TooltipQuest">Quest:</c> Hitting Heroes empowers Storm Bolt
MuradinStormboltPiercingBoltTalent=Storm Bolt pierces
MuradinStormboltSledgehammerTalent=Increases Storm Bolt damage to non-Heroes
MuradinThunderclap=Slow and damage nearby enemies
MuradinThunderclapCrowdControlTalent=Reduces Thunder Clap cooldown per target hit
MuradinThunderclapHealingStaticTalent=Thunder Clap heals you
MuradinThunderclapReverberationTalent=Increases duration and Attack Speed reduction
MuradinThunderclapThunderburnTalent=Thunder Clap strikes a second time
MuradinThunderclapThunderstrikeTalent=Increases Thunder Clap damage to one enemy
MurkyContinuousSlimeTalent=Decreased Slime cooldown
MurkyFishtank=Periodically reduces incoming Basic Attacks
MurkyHinderingSlimeTalent=Increased Slime slow amount
MurkyLivingTheDreamTalent=<c val="#TooltipQuest">Quest:</c> Living increases Ability Power
MurkyMarchOfTheMurlocs=Swarm enemies with Murlocs
MurkyMarchOfTheMurlocsNeverEndingMurlocsTalent=March of the Murloc's Murlocs last longer and march further
MurkyOctoGrab=Stun and poke an enemy Hero
MurkyOctoGrabAndASharkTooTalent=Octo-Grab deals significant damage
MurkyPufferfish=Spit out a fish that explodes after a delay
MurkyPufferfishCompressedAirTalent=Increases Pufferfish radius
MurkyPufferfishSlimyPufferfishTalent=Casts Slime at Pufferfish location
MurkyPufferfishTufferfishTalent=Increased Health
MurkyPufferfishWrathOfCodTalent=Increase Pufferfish damage on Slimed targets
MurkyRejuvenatingBubbleTalent=Safety Bubble heals you
MurkySafetyBubble=Becomes Invulnerable, but cannot attack or use abilities
MurkySafetyBubbleBubbleBreezeTalent=Gain Movement Speed when using Safety Bubble
MurkySafetyBubbleBubbleMachineTalent=Decreased cooldown
MurkySlime=Release Slime to damage and slow enemies
MurkySlimeBiggerSlimeTalent=Increases Slime radius
MurkySlimeSlimeAdvantageTalent=You deal increased Basic Attack damage to Slimed targets
MurkySlimeSlimyEndTalent=Slime is used on death
MurkySpawnEgg=Place an Egg, where you can respawn from
MurkySpawnEggAssaultEggTalent=Egg sees further, has more Health
MurkySpawnEggHiddenAssaultTalent=Gain Stealth and Movement Speed after respawning from Egg
MurkySpawnEggLivingtheDream=Place an Egg, where you can respawn from
NecromancerAmplifyDamage=Bone Prison causes Vulnerable
NecromancerBoneArmorBacklash=Bone Armor explodes for damage
NecromancerBoneArmorShackler=Bone Armor slows enemies
NecromancerBoneArmorShade=Bone Armor evades Basic Attacks
NecromancerBonePrison=Root an enemy in place
NecromancerBoneSpear=Damage enemies in a line
NecromancerCallOfTheGrave=Increases Poison Nova damage
NecromancerCursedStrikes=Basic Attacks deal damage in an area and reduce Attack Speed
NecromancerDeathsReachTalent=Increases Spectral Scythe range
NecromancerDecrepifyTalent=Spectral Scythe slows
NecromancerFlowingWoundsTalent=Reduces Spectral Scythe cooldown if Hero is hit
NecromancerGiantsCurse=Increases Cursed Strikes damage to Heroes
NecromancerHamstringTalent=Slow enemies during delay
NecromancerHarvestVitality=Cursed Strikes against Heroes heals you
NecromancerJailors=Bone Prison spawns Skeletal Warriors
NecromancerMortalWound=Spectral Scythe reduces healing taken
NecromancerPoisonNova=Poison enemies in a large area
NecromancerPoisonNovaTalent=Poison enemies around you
NecromancerRaiseSkeleton=Spawn Skeletal Warriors from Minions
NecromancerRaisedMage=Raise Frost Mages from fallen Heroes and increases slow
NecromancerSkeletalMages=Summon Frost Mages to damage and slow enemies
NecromancerSkeletonMastery=Increases maximum Skeletal Warriors and damage
NecromancerSpectralScythe=Throw a scythe that damages enemies as it returns to you
NecromancerTalentCorpseExplosion=Skeletal Warriors explode on death
NecromancerTalentRathmasBlessing=Raise Skeleton heals you
NecromancerTragOulsEssence=Raise Skeleton restores Mana
NecromancerWeaken=Increases Cursed Strikes Attack Speed slow
NexusBladesTalent=Basic Attacks deal more damage and slow
NexusFrenzyTalent=Increases Attack Speed and Range
NovaAntiArmorShellsTalent=Attack slower but hit harder
NovaCovertMission=Kill Minions or Heroes to bribe a Mercenary
NovaCovertMissionTalent=Kill Minions or Heroes to bribe a Mercenary
NovaCovertMissionToken=Kill Minions to bribe a Mercenary
NovaCovertOpsTalent=Increase Pinning Shot slow while Cloaked
NovaCovertOpsTalent2=Increase Pinning Shot slow while Cloaked
NovaDoubleFakeTalent=Create an additional Holo Decoy
NovaGhostProtocol=Activate to gain Stealth
NovaHoloDecoy=Create a decoy hologram of Nova. Ability does not break Cloak
NovaHoloDecoyHoloStabilityTalent=Increases Holo Decoy duration
NovaHoloDecoyLethalDecoyTalent=Holo Decoy does damage
NovaHoloDecoyRapidProjectionTalent=Reduces Holo Decoy cooldown and Mana cost
NovaHoloDecoyRemoteDeliveryTalent=Increases Holo Decoy cast and sight range
NovaMyKillTalent=Reduces cooldowns when you kill Heroes
NovaOneintheChamberTalent=Using an Ability empowers next Basic Attack
NovaPerfectShotTalent=Reduces Snipe cooldown versus Heroes
NovaPermanentCloakSniper=Become Stealthed while not attacking or taking damage. Increased Basic Attack and sight range
NovaPermanentCloakSniperAdvancedCloakingTalent=Increases Move Speed while Cloaked
NovaPermanentCloakSniperTacticalEspionageTalent=Increases Mana regen while Cloaked
NovaPinningShot=Slow and damage an enemy
NovaPinningShotCripplingShotTalent=Pinning Shot increases all damage done to target
NovaPinningShotDoubleTapTalent=Pinning Shot now has 2 charges
NovaPinningShotLongshotTalent=Increases Pinning Shot range
NovaPinningShotTazerRoundsTalent=Increased Pinning Shot slow duration
NovaPrecisionStrike=Area attack with unlimited range
NovaPrecisionStrikePrecisionBarrageTalent=Precision Strike can hold 2 charges
NovaSnipe=Fire a shot and deal a large amount of damage to the first enemy hit
NovaSnipeAmbushSnipeTalent=Increased Snipe range while Cloaked
NovaSnipeExplosiveRoundTalent=Snipe deals damage in an area
NovaSnipeHotShotTalent=Hitting Heroes increases Snipe damage
NovaSnipeMasterTalent=Increases Snipe damage from hitting Heroes
NovaSnipePsiOpRangefinderTalent=Increases Snipe's Range and lowers Cooldown
NovaSnipePsionicEfficiencyTalent=Removes Snipe Mana cost and increases range
NovaSnipeRailgunTalent=Snipe penetrates through enemies and cooldown is reduced
NovaTripleTap=Fire at a target 3 times
NovaTripleTapFastReloadTalent=Triple Tap cooldown resets on Hero kills
RaynorACardToPlayTalent=Hero deaths lower Heroic cooldown
RaynorAdrenalineRush=Automatically heal when low on Health
RaynorAdrenalineRushActivatable=Automatically heal when low on Health
RaynorAdrenalineRushFightOrFlightTalent=Adrenaline Rush activateable, grants Resistant
RaynorAdrenalineRushGiveMeMoreTalent=Adrenaline Rush heals more
RaynorAdvancedOptics=Increased Basic Attack and sight range
RaynorHyperion=Call down a strafing Battlecruiser
RaynorHyperionGroundStrafeTalent=More shots dealing area damage
RaynorInspire=Increase Attack Speed for self and allies
RaynorInspireRevolutionOverdriveTalent=Gain Movement Speed per inspired Hero
RaynorInspireSteelResolveTalent=Inspire lasts longer and activates with Adrenaline Rush
RaynorLeadFromTheFrontPuttinOnAClinicTalent=Reduces cooldowns when killing enemy minions
RaynorPenetratingRound=Fire a shot damaging and knocking back enemies in a line
RaynorPenetratingRoundBullseyeTalent=First enemy hit by Penetrating Round is stunned
RaynorPenetratingRoundClusterRoundTalent=Penetrating Round does more damage per target hit and has increased width
RaynorPenetratingRoundConfidentAimTalent=Reduces Penetrating Round cooldown when hitting a Hero
RaynorPenetratingRoundDoubleBarreledTalent=Penetrating Round gains a second charge
RaynorPenetratingRoundHamstringShotTalent=Penetrating Round slows
RaynorRaynorsRaiders=Summon a pair of Banshee escorts<n/>
RaynorRaynorsRaidersHelsAngelsTalent=Banshees stay cloaked and attack more frequently
RaynorRelentlessLeaderTalent=Reduces Adrenaline Rush cooldown and knocks back on Stun or Root
RehgarAncestralHealing=Significantly heal allied Hero
RehgarAncestralHealingFarseersBlessingTalent=Increases heal and heals in area
RehgarBloodlust=Give allied Heroes Movement Speed and Attack Speed
RehgarBloodlustGladiatorsWarShoutTalent=Bloodlust causes Basic Attacks to heal
RehgarChainHeal=Create a healing wave that jumps between allies
RehgarChainHealChainReactionTalent=Increases Chain Heal on Lightning Shielded allies
RehgarChainHealHealingSurgeTalent=Increases Chain Heal amount and heal an additional target
RehgarChainHealSpiritwalkersGraceTalent=Reduces Chain Heal Mana cost
RehgarChainHealTidalWavesTalent=Reduces Chain Heal cooldown
RehgarEarthbindTotem=Creates a totem that slows nearby enemies
RehgarEarthbindTotemColossalTotemTalent=Increases Earthbind Totem area and range
RehgarEarthbindTotemEarthgraspTotemTalent=Increases Earthbind Totem initial slow
RehgarEarthlivingEnchant=Empowers Chain Heal on low Health Heroes
RehgarFarsight=Activate to reveal target area and nearby enemies
RehgarGhostWolf=Transform into a Ghost Wolf
RehgarGhostWolfActivate=Transform into a Ghost Wolf
RehgarGhostWolfFeralHeartTalent=Increases Health and Mana Regen in Ghost Wolf
RehgarGhostWolfWolfRunTalent=Increases Ghost Wolf Move Speed
RehgarHealingTotem=Activate to place a ward which heals in an area
RehgarHungeroftheWolfTalent=Ghost Wolf attacks do extra damage and heal you
RehgarLightningShield=Imbue target ally with lightning, causing damage to nearby enemies
RehgarLightningShieldEarthShieldTalent=Lightning Shield gives a Shield
RehgarLightningShieldElectricChargeTalent=Increases Lightning Shield radius
RehgarLightningShieldLightningBondTalent=Lightning Shield is also cast on you
RehgarLightningShieldReactiveSparkTalent=Reduces Lightning Shield cooldown and waits to start
RehgarLightningShieldStormcallerTalent=Lightning Shield returns Mana
RehgarRisingStorm=Increases Lightning Shield damage with each hit
RehgarTotemicProjection=Instantly move a totem to a new location
RehgarTotemicProjectionTalent=Earthbind Totem can be moved once
RexxarAspectOfTheHawkTalent=Spirit Swoop increases Attack Speed
RexxarAspectoftheBeastTalent=Misha's Basic Attacks lower Misha, Charge! cooldown
RexxarBarkskinTalent=Misha takes reduced Ability Damage after charging
RexxarBearNecessitiesTalent=Cast Misha, Charge! again if you don't hit a Hero
RexxarBestialWrath=Increases Misha's Basic Attacks
RexxarBloodOfTheRhinoTalent=Increases Mend Pet duration
RexxarCripplingTalonsTalent=Increases Spirit Swoop slow amount and duration
RexxarCriticalCareTalent=Increases Mend Pet healing when Misha is low
RexxarFeignDeath=Become Invulnerable and control Misha
RexxarFlare=Gain vision of an area
RexxarFrenzyofKalimdorTalent=Your Basic Attacks deal more damage and Misha's attacks slow
RexxarHardenedSkin=You and Misha take reduced damage
RexxarHungryBearTalent=Misha's Basic Attacks heal her
RexxarHunterGathererTalent=<c val="#TooltipQuest">Quest:</c> Regen Globes grant Health Regen
RexxarMendPet=Heal Misha over time
RexxarMishaChargeRedirect=Order Misha to charge, damaging and stunning enemies
RexxarMishaFollowHeroSelect=Misha attacks your enemies
RexxarSpiritBondEasyPreyTalent=Misha is more effective against Minions and Mercs
RexxarSpiritBondGrizzledBearTalent=Misha gains Block
RexxarSpiritBondPrimalIntimidationTalent=Activate to slow enemy Attack and Move speed
RexxarSpiritBondTalent=Increases Bestial Wrath duration and Misha heals you
RexxarSpiritBondWildfireBearTalent=Misha deals damage to nearby enemies
RexxarSpiritSwoop=Launch a hawk to damage enemies and slow them
RexxarSpiritSwoopBirdOfPreyTalent=Increases Spirit Swoop damage to Minions and Mercs
RexxarSurvivalistTrainingTalent=Regen Globes restore more Mana
RexxarTakingFlightTalent=Increases Spirit Swoop range, returns Mana
RexxarThrilloftheHuntTalent=Basic Attacks increase Move Speed
RexxarThrowingAxesTalent=Increases Basic Attack range
RexxarUnleashTheBoars=Send a pack of boars to hunt enemy Heroes
RexxarUnleashTheBoarsKillCommandTalent=Unleash the Boars deals more damage and roots
IllusionMasterImageSelfCast=Switch places with Samuro
SamuroAdvancingStrikes=Increase Movement Speed when attacking Heroes
SamuroBlademastersPursuitTalent=Increase Advancing Strikes effect and duration
SamuroBladestorm=Become an unstoppable whirlwind of death
SamuroBurningBlade=Critical Strikes damage nearby enemies
SamuroCriticalStrike=Critically Strike for increased damage.
SamuroDanceOfDeathTalent=Images use Bladestorm
SamuroDeflectionTalent=Advancing Strikes reduces incoming attacks
SamuroHarshWinds=Attack from Wind Walk to increase damage
SamuroIllusionMaster=Images can be controlled
SamuroImageAIDsiabled=Select Samuro Prime
SamuroImageAIEnabled=Select Samuro Prime
SamuroImageDancer=You can control Mirror Images separately or as a group
SamuroImageSwap=Swap positions with target Mirror Image.
SamuroLethalIntentTalent=[PH] Critical Strike makes target Vulnerable
SamuroMercilessStrikes=Always Critically Strike disabled targets
SamuroMirage=Mirror Image grants Spell Block
SamuroMirrorImage=Create Mirror Images to confuse and attack enemies
SamuroMirroredSteelTalent=Attacks reduce Mirror Image cooldown
SamuroOneWithTheWindTalent=Take less damage while Wind Walking
SamuroOverpoweringBlow=Critical Strike has two charges
SamuroPhantomsStrikeTalent=Images increase Critical Strike damage
SamuroPressTheAttack=Advancing Strikes increases Attack Speed
SamuroSelectAll=Select All
SamuroSelectMirrorImages=Select Mirror Image
SamuroSelectSamuroPrime=Select Samuro
SamuroShukuchiTalent=Wind Walk teleports you
SamuroSplitForm=Create two Mirror Images instantly.
SamuroThreeBladeStyleTalent=Images have increased Health and Duration
SamuroThreeBladeStyleTalent2=[PH] Illusion Master cooldown reduced, Images last indefinitely
SamuroWayOfIllusion=<c val="#TooltipQuest">Quest:</c> Image Critical Strikes empower Basic Attacks
SamuroWayOfIllusionComplete=<c val="#TooltipQuest">Quest:</c> Increase Basic Attack damage
SamuroWayOfTheWind=<c val="#TooltipQuest"> Quest:</c> Attacks from Stealth empower Wind Walk
SamuroWayoftheBlade=Critical Strike happens more often
SamuroWhispersFromtheWindTalent=[PH] Attacking from Wind Walk will do <c val="#TooltipNumbers"><d ref="Effect,SamuroWhispersFromtheWindDamage,Amount"/></c> bonus damage
SamuroWindStrider=Greatly reduce Wind Walk cooldown
SamuroWindwalk=Become Stealthed and gain Movement Speed
WindwalkKawarimiTalent=Wind Walk creates an Image
SgtHammerArtillery=Deal more damage to enemies that are far away
SgtHammerArtilleryAdvancedArtilleryTalent=Increase damage to distant enemies
SgtHammerArtilleryFirstStrikeTalent=Basic Attacks do extra damage if not attacked
SgtHammerArtilleryMaelstromShellsTalent=Increase Basic Attack range
SgtHammerBluntForceGun=Fire a large bullet across the map
SgtHammerBluntForceGunOrbitalBFGTalent=BFG repeatedly travels through the map
SgtHammerConcussiveBlast=Knock back and damage enemies
SgtHammerConcussiveBlastBarricadeTalent=Concussive Blast creates a wall
SgtHammerConcussiveBlastExcessiveForceTalent=Double the knock back distance
SgtHammerConcussiveBlastLethalBlastTalent=Increase Concussive Blast damage
SgtHammerNapalmStrike=Fire damaging napalm at enemies
SgtHammerNapalmStrikeAdvancedLavaStrikeTalent=Increased range and impact damage
SgtHammerSiegeMode=Become immobile to increase range and empower Basic Attacks
SgtHammerSiegeModeAmbushTalent=Stealth and extra damage in Siege Mode
SgtHammerSiegeModeGraduatingRangeTalent=Gradually increase range in Siege Mode
SgtHammerSiegeModeHoverSiegeModeTalent=Move slowly in Siege Mode
SgtHammerSiegeModeResistantTalent=Stuns and Roots reduce damage taken while in Siege Mode
SgtHammerSpiderMines=Create mines that slow and damage enemies on contact
SgtHammerSpiderMinesBullheadMinesTalent=Middle Spider Mine knocks back
SgtHammerSpiderMinesMineFieldTalent=Spawn 2 more mines.
SgtHammerSpiderMinesSlowingMinesTalent=Increase slow amount and duration
SgtHammerThrusters=Increase your Movement Speed by <c val="#TooltipNumbers"><d ref="100* Behavior,SgtHammerThrusters,Modification.UnifiedMoveSpeedFactor"/>%</c> for <c val="#TooltipNumbers"><d ref="Behavior,SgtHammerThrusters,Duration" player="0"/></c> seconds
SgtHammerThrustersHyperCoolingEnginesTalent=Thrusters cooldown reduced
SonyaIgnorePain=Activate to reduce damage taken
SonyaNervesOfSteel=Activate to gain a Shield
StitchesDevour=Damage an enemy and restore Health
StitchesDevourChewYourFoodTalent=Also heals you over time
StitchesDevourIndigestionTalent=Devour creates a Retchling
StitchesDevourLastBiteTalent=Reduced cooldown on kill
StitchesDevourSavorTheFlavorTalent=Devouring Heroes gives permanent Health regeneration
StitchesFleaBag=Stuns and Roots reduce Cooldowns
StitchesGorge=Completely consume an enemy Hero
StitchesGorgeHungryHungryStitchesTalent=Gorge can eat multiple Heroes and does more damage
StitchesHelpingHand=Pull the first target hit towards you
StitchesHook=Pull the first target hit towards you
StitchesHookFishingHookTalent=Increased range
StitchesHookHelpingHandTalent=Hook can pull allied Heroes with reduced cooldown
StitchesHookHelpingHandTalentCancel=Hook only hits enemies
StitchesHookShishKabobTalent=Hook pulls 2 targets
StitchesHungryforMore=<c val="#TooltipQuest">Quest:</c> Regen Globes increase Health
StitchesPutridBile=Emit a slowing bile puddle
StitchesPutridBileRegenerativeBileTalent=Putrid Bile lasts longer and heals Stitches
StitchesRestorativeFumes=Vile Gas damage heals you
StitchesSlam=Damage enemies in an area
StitchesSlamHeavySlamTalent=Increased Slam damage
StitchesSlamMegaSmashTalent=Increases size of Slam
StitchesSlamPulverizeTalent=Reduces Slam cooldown and adds slow
StitchesSlamPutridGroundTalent=Slam infects with Vile Gas
StitchesVileGas=When struck, damage nearby enemies over time
StitchesVileGasTenderizerTalent=Basic Attacks slow enemies
StitchesVileGasToxicGasTalent=Increases area and damage of Vile Gas
StitchesVileGasVileCleaverTalent=Basic Attacks create Vile Gas
Sundering=Damages, pushes, and stuns enemies in a line
SylvanasBlackArrows=Attacks and Abilities stun Minions, Mercenaries, and Towers
SylvanasBlackArrowsCorruptionTalent=Basic Attacks destroy Ammo
SylvanasBlackArrowsLifeDrainTalent=Shadow Dagger heals
SylvanasBlackArrowsOverwhelmingAfflictionTalent=Black Arrows slows Heroes
SylvanasBlackArrowsParalysisTalent=Increases Black Arrows duration
SylvanasBlackArrowsUnstablePoisonTalent=Black Arrows explodes Minions on death
SylvanasDarkLadysCallMindControlTalent=Increase Mind Controlled enemies Move Speed
SylvanasHauntingWave=Deals damage and allows teleportation
SylvanasHauntingWaveFree=Deals damage and allows teleportation
SylvanasHauntingWaveRangersAmbushTalent=Haunting Wave refills Withering Fire
SylvanasHauntingWaveShadeFormTalent=Haunting Wave grants Stealth
SylvanasHauntingWaveWindrunnerTalent=Haunting Wave recharges Withering Fire and is usable twice
SylvanasMercenaryQueenTalent=Nearby Mercs are stronger
SylvanasMindControl=Briefly control an enemy Hero
SylvanasMindControlCancel=Cancel Mind Control
SylvanasPossession=Convert enemy Minions
SylvanasPossessionDarkLadysCallTalent=Increases charges, reduces recharge time, can possess Mercs
SylvanasRemorselessTalent=Abilities increase Basic Attack damage
SylvanasShadowDagger=Damages an enemy over time and spreads
SylvanasShadowDaggerColdEmbraceTalent=Shadow Dagger makes target Vulnerable
SylvanasShadowDaggerLostSoulTalent=Reduces Shadow Dagger cooldown on Heroes
SylvanasWailingArrow=Fire arrow that damages and silences
SylvanasWailingArrowDeafeningBlastTalent=Increases power of Wailing Arrow center
SylvanasWillOfTheForsaken=Activate to gain Unstoppable and Move Speed
SylvanasWitheringFire=Shoot an arrow at the closest enemy. Gains charges when enemies are killed<n/>
SylvanasWitheringFireBarbedShotTalent=Withering Fire deals triple damage to non-Heroic units.
SylvanasWitheringFireEvasiveFireTalent=Withering Fire grants Move Speed
SylvanasWitheringFireOverflowingQuiverTalent=Withering Fire on Minion kills
SylvanasWitheringFireSplinterShotTalent=Withering Fire hits a second enemy
SylvanasWitheringFireWithTheWindTalent=Increases Withering Fire range
SylvanasWitheringFireWitheringBarrage=Withering Fire gains an additional charge and fires faster
TalentBribeToken=Kill Minions to bribe a Mercenary
TalentDampenMagic=Periodically reduces incoming Ability Damage
TassadarArchon=Gains Basic Attack damage and a Shield
TassadarArchonTwilightArchonTalent=Increased Shield, damage, and Basic Attack range
TassadarDimensionalShift=Become temporarily invulnerable and invisible
TassadarDimensionalShiftDeepShiftTalent=Increased duration of Dimensional Shift
TassadarDimensionalShiftDimensionalWarpTalent=Increases Movement Speed and gain Health while using Dimensional Shift
TassadarDimensionalShiftPrescienceTalent=Automatically activates at low Health
TassadarForceWall=Creates an unpathable wall
TassadarForceWallForceBarrierTalent=Force Wall has increased range and duration
TassadarOracle=<li/>Activate to greatly increase vision radius and detect enemy Heroes
TassadarOracleDistortionBeamTalent=Basic Attacks slow enemies
TassadarOracleMentalAcuityTalent=Reduces Oracle cooldown
TassadarOracleScryerTalent=Increased Oracle duration and it gives Movement Speed
TassadarPlasmaShield=Shield an ally or self temporarily
TassadarPlasmaShieldEmpoweredShielding=Allied Shielding increased
TassadarPlasmaShieldEvasiveShieldingTalent=Increases Movement Speed of target
TassadarPlasmaShieldKhalasEmbraceTalent=Half of expired Shields are retained
TassadarPlasmaShieldLeechingPlasmaTalent=Target's Basic Attacks restore Health
TassadarPlasmaShieldReinforceStructureTalent=More powerful on Structures
TassadarPsionicStorm=Damage enemies in an area
TassadarPsionicStormOverloadTalent=Psionic Storm's Range increased
TassadarPsionicStormPsiInfusionTalent=Psionic Storm returns Mana per target hit
TassadarPsionicStormResonationTalent=Psionic Storm slows targets
TassadarPsionicStormSecondStrikeTalent=Can use Psionic Storm twice in succession
TassadarPsionicStormStaticChargeTalent=Enemies hit by Psionic Storm take extra damage from your Basic Attacks
ThrallChainLightning=Blast 3 enemies with lightning
ThrallEarthenShieldsTalent=Grants allies Shields in area
ThrallEarthquake=Slows enemies in a massive area
ThrallFeralSpirit=Releases a fiery wolf spirit to burn enemies and root Heroes
ThrallForkedLightningTalent=Chain Lightning gains another charge
ThrallFrostwolfResilience=Casting Abilities on enemies grants charges that heal you
ThrallFrostwolfResilienceSurgeOfHealing=Activate Frostwolf Resilience to instantly heal
ThrallGraceOfAirTalent=Windfury grants double Frostwolf Resilience
ThrallManaTideTalent=Frostwolf Resilience also restores Mana
ThrallRabidWolvesTalent=Feral Spirit grants more Frostwolf Resilience
ThrallRestlessWolvesTalent=Reduces Feral Spirit cooldown on Hero impact
ThrallRideTheLightningTalent=Chain Lightning hits more enemies
ThrallRideTheWindTalent=Increases Windfury Move Speed and extends duration on attack
ThrallRollingThunderTalent=Increases Chain Lightning range and attacks restore Mana
ThrallSpiritJourneyTalent=Increases Feral Spirit range
ThrallStoneWolvesTalent=Increases Feral Spirit root duration
ThrallTempestFuryTalent=Windfury's final strike hits 3 times
ThrallWindShearTalent=Reduces Windfury cooldown
ThrallWorldbreakerTalent=Sundering travels indefinitely
TinkerARKReaktor=Reduces Xplodium Charge cooldown and it can give turret charges
TinkerDethLazor=Charge and shoot a laser. Damage and range increases the longer it is charged
TinkerDethLazorEZPZDimensionalRipperTalent=Deth Lazor disables enemies
TinkerDethLazorGoblinFusionTalent=Deth Lazor deals more damage
TinkerDethLazorHyperfocusCoilsTalent=Deth Lazor charges faster
TinkerFirinMahLazorz=Rock-It! Turrets fire Deth Lazorz
TinkerGravOBomb3000=Pulls and damages enemies
TinkerGravOBombMiniatureBlackHoleTalent=Increases Grav-O-Bomb radius and damage
TinkerInitialAid=Activate to heal over time, cooldown reduced by scrap
TinkerItsRainingScrap=Activate to create Scrap around you
TinkerRoboGoblinMechaLordTalent=Robo-Goblin deals bonus damage to Heroes
TinkerRoboGoblinPassive=Empower Basic Attacks to non-Heroes and control Rock-It! Turrets
TinkerRockItTurret=Create a turret that shoots at nearby enemies
TinkerRockItTurretClockwerkSteamFistsTalent=<c val="#TooltipQuest">Quest:</c> Basic Attacks increase Rock-It! Turret duration
TinkerRockItTurretEngineGunkTalent=Rock-it! Turrets slow enemies
TinkerRockItTurretLongRangedTurretsTalent=Increases Rock-it! Turret attack range
TinkerRockItTurretRockItTurretXLTalent=Rock-It! Turrets attack multiple enemies
TinkerRockItTurretTurretStorageTalent=Increases Rock-it! Turret charges
TinkerSalvager=Turrets and enemy Structures drop Scrap that restore Mana and reduce cooldowns
TinkerSalvagerBreakItDownTalent=Increases Salvager cooldown reduction
TinkerSalvagerReduceReuseRecycleTalent=Enemy Minions can drop Scrap
TinkerSalvagerScrapOMaticSmelterTalent=Increases Salvager Mana restoration
TinkerSuperiorSchematics=Increases Rock-it! Turret damage
TinkerXplodiumCharge=Throw a timed bomb which stuns and damages enemies in an area
TinkerXplodiumChargeExtraTNTTalent=Xplodium Charge deals more damage
TinkerXplodiumChargeKwikReleaseChargeTalent=Xplodium Charge gains second charge
TinkerXplodiumChargeXtraLargeBombsTalent=Increases Xplodium Charge range and radius
TracerBlink=Dash towards an area
TracerBlinkHeroSelect=Dash towards an area
TracerBulletSprayMelee=Melee hits all enemies in range
TracerBulletTime=Basic Attacks reduce Blink cooldown
TracerCompositionBPulseBomb=Hitting Heroes with Pulse Bomb leaves a second
TracerFocusFire=Unloading a magazine on an enemy does bonus damage
TracerGetStuffedMelee=Reduces Melee cooldown and knocks away
TracerIsthataHealthPack=Increases Regen Globe and Healing Fountain healing
TracerJumper=Increases Blink charges
TracerLeechingRounds=Basic Attacks against Heroes heal you
TracerLockedandLoaded=Time Reload perfectly to gain Basic Attack damage
TracerLockedandLoadedAbility=Time Reload perfectly to gain Basic Attack damage
TracerMelee=Attack a nearby enemy
TracerPartingGift=Using Recall leaves bombs
TracerPulseBomb=Attach a bomb to enemies that deals heavy damage
TracerPulseRounds=Increases Pulse Bomb range and charge rate
TracerPulseStrikeMelee=Increases Melee Pulse Bomb charge rate
TracerQuantumSpike=Increases Pulse Bomb single target damage
TracerRecall=Return to a recent location and remove negative effects
TracerReload=You can move while Basic Attacking and Basic Attacks cost ammo
TracerRicochetHeroWeapon=Basic Attacks can bounce to a nearby enemy
TracerSleightofHand=Reload twice as fast
TracerSlipstreamRecall=Recall rewinds more time
TracerSpatialEcho=Takedowns grant Blink charges
TracerStickyBomb=Increases Pulse Bomb area and adds slow
TracerTotalRecallRecall=Recall can heal you but has increased cooldown
TracerTracerRounds=Basic Attacks reveal enemies
TracerUntouchable=<c val="#TooltipQuest">Quest:</c> Takedowns increase Attack Damage
TychusCombatTactician=Basic Attacks reduce Run and Gun cooldown
TychusCommandeerOdin=Call down an Odin to pilot
TychusCommandeerOdinAnnihilate=Deals damage in a line
TychusCommandeerOdinBigRedButtonTalent=Increases Odin duration and fires Nukes
TychusDrakkenLaserDrill=Call down a Laser to attack nearby enemies
TychusDrakkenLaserFocusingDiodesTalent=Increase Laser Drill range and damage
TychusFinishingRounds=Increased damage on consecutive attacks
TychusFragGrenade=Throw a grenade, damaging and knocking back enemies
TychusFragGrenadeConcussionGrenadeTalent=Increases Frag Grenade radius and knockback
TychusFragGrenadeMeltingPointTalent=Frag Grenade does bonus damage to Minions and Structures
TychusFragGrenadeQuarterbackTalent=Increased Frag Grenade range
TychusFragGrenadeShredderGrenadeTalent=Increased Frag Grenade radius
TychusFragGrenadeTitanGrenadeTalent=Increases Frag Grenade damage to Heroes
TychusFullyLoaded=Reduces Minigun cooldown
TychusFuryoftheStormTalent=Basic Attacks deal damage to nearby enemies
TychusIntheRhythmTalent=<c val="#TooltipQuest">Quest:</c> Basic Attacks increase Minigun duration
TychusMasterAssassinTalent=<c val="#TooltipQuest">Quest:</c> Takedowns increase your Attack Speed
TychusMinigun=Activate to increase Basic Attack damage to Heroes
TychusMinigunActive=Activate to increase Basic Attack damage to Heroes
TychusMinigunRapidFireTalent=Increased sustained Attack Speed
TychusNeosteelCoatingTalent=Activate to reduce Ability Damage
TychusOverkill=Attack one target while moving, damaging nearby enemies as well
TychusOverkillArmorPiercingRoundsTalent=Increases Overkill damage to main target
TychusOverkillLeadRainTalent=Overkill slows targets
TychusOverkillSprayNPrayTalent=Increases Overkill range
TychusPressTheAdvantage=Run and Gun increases your Basic Attack range
TychusProblemSolverTalent=Empowers your Basic Attacks against Heroes
TychusRelentlessSoldierTalent=Stuns and Roots grant Resistant
TychusRunAndGunBobAndWeaveTalent=Adds Run and Gun charges and reduces Mana cost
TychusRunAndGunShrugItOff=Run and Gun grants Resistant
TychusRunandGun=Dash a short distance
TychusRunandGunDashTalent=<c val="#TooltipQuest">Quest:</c> Regen Globes empower Run and Gun
TychusRunandGunStimpackTalent=Bonus Movement Speed and Attack Speed
TychusShrugitOff=Grants Resistant
TychusSizzlinAttacks=Basic Attacks deal more damage to Heroes
TychusThatsTheStuff=Minigun damage heals you
TychusTheBiggerTheyAre=Minigun Damage modified based on Target Health
TychusVigorousAssaultTalent=Basic Attacks heal you
TyraelAngelicMomentum=Basic Attacks reduce Ability cooldowns
TyraelArchangelsWrath=When you die, become invulnerable and explode
TyraelArchangelsWrathEvenInDeathTalent=Can use Basic Abilities before exploding
TyraelArchangelsWrathProtectionInDeathTalent=Upon death, grants nearby allies a Shield
TyraelElDruinsMight=Slow and damage enemies in an area. Use ability again to teleport to the area
TyraelElDruinsMightAngelsGraceTalent=El'druin's Might teleport grants Movement Speed
TyraelElDruinsMightBladeOfJusticeTalent=El'druin's Might teleport increases Attack Speed
TyraelElDruinsMightHolyGroundTalent=Teleporting using El'Druin's Might makes a blocking field
TyraelElDruinsMightHoradricReforgingTalent=Reduces El'druin's Might cooldown when enemy is hit
TyraelJudgment=Charge and stun an enemy Hero
TyraelJudgmentAngelOfJusticeTalent=Judgment has increased range, reduced cooldown
TyraelRighteousness=Gain a temporary Shield
TyraelRighteousnessAngelicAbsorptionTalent=Grants Health Regeneration when attacked
TyraelRighteousnessImposingWillTalent=Slows enemy Attack Speed and Movement Speed
TyraelRighteousnessReciprocateTalent=Shield explodes on breaking
TyraelRighteousnessSalvationTalent=Stronger Shield per nearby allied Hero
TyraelRighteousnessZealotryTalent=Increases Righteousness' duration and reduces cooldown
TyraelSanctificationHolyArenaTalent=Sanctification increased duration, adds damage bonus
TyraelSanctificationStationary=Create zone of Invulnerable
TyraelSmite=Damage an area and speed up nearby allies
TyraelSmiteAngelicMightTalent=Increased Basic Attack damage
TyraelSmitePurgeEvilTalent=Increased Smite damage to Heroes
TyraelSmiteSwiftRetributionTalent=Increases Smite's Movement Speed bonus and duration
TyrandeHuntersMark=Reveals and increases damage taken by marked target
TyrandeHuntersMarkHuntressFuryTalent=Gain Attack Speed when using Hunter's Mark
TyrandeHuntersMarkMarkOfMendingTalent=Marked enemies heal attackers
TyrandeHuntersMarkRangersMarkTalent=Reduce Cooldown of Hunter's Mark
TyrandeHuntersMarkTrueshotAuraTalent=Gain Attack Damage aura
TyrandeLightOfElune=Heal an allied Hero and self
TyrandeLightOfEluneCelestialAttunementTalent=Reduce Mana cost of Light of Elune
TyrandeLightOfEluneOverflowingLightTalent=Light of Elune has increased healing while at high Health
TyrandeLightOfEluneQuickeningBlessingTalent=Light of Elune also increases Movement Speed
TyrandeLunarFlare=Stun and damage enemies in an area
TyrandeLunarFlareLunarBlazeTalent=Lunar Flare increased range
TyrandeLunarFlareShootingStarTalent=Lunar Flare deals extra damage and refunds Mana on hit
TyrandeLunarMomentum=Basic Attacks reduce Ability cooldowns
TyrandeSearingArrows=Activate to increase Basic Attack damage at the cost of Mana
TyrandeSentinel=Fire a scouting Owl that reveals and damages enemy Heroes
TyrandeSentinelEmpowerTalent=Reduces cooldowns on hit
TyrandeSentinelPierceTalent=Sentinel hits multiple targets
TyrandeSentinelRangerTalent=Sentinel has increased width and damage
TyrandeShadowstalk=Allies gain Stealth and are healed
TyrandeShadowstalkHuntersSwiftnessTalent=Allies gain Movement Speed 
TyrandeStarfall=Damages and slows enemies in an area
TyrandeStarfallCelestialWrathTalent=Starfall has global cast range, and increased damage
UtherBeaconofLight=Healing Allies also heals you
UtherBenedictionHotbar=Activate to reduce Mana cost and cooldown of next ability
UtherBoundlessConvictionTalent=Increases Holy Radiance width and length
UtherBurdenOfGuiltTalent=Hammer of Justice slows after it stuns
UtherDivineShield=Give ally Invulnerable and increased Move Speed
UtherDivineShieldBulwarkofLightTalent=Increases Divine Shield duration and reduces cooldown
UtherDivineStorm=Damage and stun nearby enemies
UtherDivineStormDivineHurricaneTalent=Increases Divine Storm radius and reduces cooldown
UtherEternalDevotion=When killed, Uther's spirit remains temporarily on the battleground
UtherEternalDevotionBlessedChampionTalent=After using Holy Light, Basic Attacks heal nearby ally Heroes
UtherEternalDevotionHammeroftheLightbringerTalent=Basic Attacks restore Mana
UtherHammerofJustice=Stun and damage an enemy
UtherHammerofJusticeFistofJusticeTalent=Basic Attacks reduce Hammer of Justice cooldown
UtherHolyFireTalent=Deals damage to nearby enemies
UtherHolyLight=Heal an ally
UtherHolyLightHolyShockTalent=Holy Light can be used on enemies to damage them
UtherHolyLightReachTalent=Increases Holy Light and Flash of Light range
UtherHolyRadiance=Heal allies and damage enemies in a line
UtherHolyRadianceGatheringRadianceTalent=Holy Radiance gains power with more targets hit
UtherHolyRadianceGatheringRadianceTalentToken=Holy Radiance gains power with more targets hit
UtherHolyRadianceWaveofLightTalent=Healing Heroes restores Mana and reduces Cooldown
UtherRedemptionTalent=Resurrect after spirit ends
UtherRighteousDefense=Holy Light reduces damage taken
Windfury=Increases Attack and Movement Speed
WitchDoctorBigVoodoo=Increase Voodoo Ritual bonuses
WitchDoctorCorpseSpiders=Damage enemies and summon spiders to attack your enemies
WitchDoctorGargantuan=Summon a Gargantuan to guard an area
WitchDoctorGargantuanHumongoidTalent=Reduce Gargantuan cooldown and mana cost
WitchDoctorGuardianToads=Toads grant Resistant
WitchDoctorHexedCrawlers=Corpse Spiders restore Health and Mana
WitchDoctorPandemic=<c val="#TooltipQuest">Quest:</c> Empower Plague of Toads
WitchDoctorPandemicToken=<c val="#TooltipQuest">Quest:</c> Hit Heroes with Toads to empower Plague of Toads
WitchDoctorPandemicTokenComplete=<c val="#TooltipQuest">Quest:</c> Hit Heroes with Toads to empower Plague of Toads
WitchDoctorPlagueOfToads=Summon a wave of exploding toads
WitchDoctorPlagueOfToadsToadsOfHugenessTalent=Toads become more powerful with each hop
WitchDoctorRavenousSpirit=Channel a damaging, movable spirit 
WitchDoctorRavenousSpiritAnnihilatingSpiritTalent=Increase range and speed of Ravenous Spirit
WitchDoctorRingOfPoison=Deals damage in center area
WitchDoctorSoulHarvest=Activate to increase Health and Ability Power
WitchDoctorSpiderColony=Corpse Spiders cooldown reduced at high Health
WitchDoctorSpiritofArachyr=More Corpse Spiders against single enemy
WitchDoctorSuperstition=Take less damage from Abilities, but take more from Basic Attacks
WitchDoctorThingOfTheDeepTalent=Increase the range of your Abilities
WitchDoctorToadAffinityTalent=Damage against heroes reduces cooldown
WitchDoctorVileInfection=<c val="#TooltipQuest">Quest:</c> Empower Voodoo Ritual
WitchDoctorVoodooRitualBloodRitualTalent=Voodoo Ritual restores Health and Mana
WitchDoctorVoodooRitualToken=Basic Attacks and Abilities deal damage over time. Killed minions increase Health and Mana.
WitchDoctorVoodooRitualTrait=Basic Attacks and Abilities deal damage over time. Killed minions increase Health and Mana.
WitchDoctorWidowmakers=<c val="#TooltipQuest">Quest:</c> Empower Corpse Spiders
WitchDoctorWidowmakersToken=<img path="@UI/StormTalentInTextQuestIcon" alignment="uppermiddle" color="B48E4C" width="20" height="22"/>Hitting Heroes empowers Corpse Spiders
WitchDoctorWidowmakersTokenComplete=<img path="@UI/StormTalentInTextQuestIcon" alignment="uppermiddle" color="B48E4C" width="20" height="22"/>Hitting Heroes empowers Corpse Spiders
WitchDoctorZombieWall=Summon a temporary ring of zombies that trap and attack
WitchDoctorZombieWallDeadRushTalent=Zombie Wall deals more damage and uproots
WitchDoctorZombieWallFreshCorpsesTalent=Reduces Zombie Wall cooldown
WizardAetherWalkerTalent=Teleport costs no Mana when out of combat
WizardArcaneOrb=Launch an orb that deals increasing damage the further it travels
WizardArcaneOrbArcaneOrbitTalent=Increases Arcane Orb range
WizardArcaneOrbArcaniteOrbTalent=Arcane Orb grows as it travels
WizardArcaneOrbObliterationTalent=Takedowns increase Arcane Orb's damage
WizardArcaneOrbPiercingOrbTalent=Arcane Orb now pierces
WizardArcaneOrbRansorsFollyTalent=Arcane Orb does even more damage from afar
WizardArcaneOrbTriumvirateTalent=Reduces Arcane Orb cooldown at max range
WizardArcaneOrbZeisVengeanceTalent=Arcane Orb does more damage from afar
WizardArchonPurePowerDisintegrate=Long range channeled beam
WizardArchonPurePowerHotbar=Use Disintegrate repeatedly, but no other Abilities
WizardArchonPurePowerHotbarCancel=Cancel Archon: Pure Power.
WizardAstralPresence=Increases Mana regen while low Mana
WizardCannoneerTalent=Abilities empower Basic Attacks
WizardDisintegrate=Long range channeled beam
WizardDisintegrateConvergenceTalent=Disintegrate does bonus damage if beam holds
WizardDisintegrateTemporalFluxTalent=Disintegrate slows enemies
WizardDominanceTalent=Takedowns restore Health
WizardEnergyArmor=More mana regen while low on mana
WizardFirebirdsFineryTalent=Resurrect if you would die
WizardFireflies=Magic Missiles move faster, lower cooldown and Mana cost
WizardForceArmorTalent=Magic Missiles grants Spell Block
WizardGlassCannonTalent=Gain Ability Power but lose max Health
WizardMagicMissiles=Fire a volley of missiles
WizardMagicMissilesChargedBlastTalent=Magic Missiles marks enemies for bonus damage
WizardMagicMissilesMirrorballTalent=Fires 2 extra Magic Missiles and increases Mana cost
WizardMagicMissilesSeekerTalent=Increases Magic Missiles single-target damage
WizardPowerHungryTalent=Regen Globes give Ability Power and more Mana
WizardSpectralBladesTalent=Gain a stronger, melee Basic Attack
WizardSuperiorityTalent=Takedowns restore Mana
WizardTalRashasElementsTalent=Cycle abilities to gain Ability Power
WizardTeleport=Teleport a short distance
WizardTeleportCalamityTalent=Teleport deals damage
WizardTeleportDiamondSkinTalent=Teleport grants a Shield
WizardTeleportIllusionistTalent=Increases Teleport range and damage refreshes cooldown
WizardTeleportPrismTalent=Teleport makes your next Ability free
WizardTeleportWormholeTalent=Can cast Teleport twice
WizardTraitCriticalMass=Takedowns refresh your Ability cooldowns
WizardWaveOfForce=Damage and knock enemies back
WizardWaveOfForceMirrorMimics=Causes a cascade of Wave of Forces around you
WizardWaveOfForceRepulsionTalent=Increases cast range and knockback distance
ZagaraBanelingBarrage=Launch a Baneling that explodes on contact with an enemy
ZagaraBanelingBarrageBanelingMassacreTalent=Increases number of Banelings
ZagaraBanelingBarrageCentrifugalHooksTalent=Banelings can travel twice as far
ZagaraBanelingBarrageVolatileAcidTalent=Increase Baneling range and non-Hero damage
ZagaraCorrosiveSalivaHunterKillerTalent=Empowers Hunter Killers against Heroes
ZagaraCreepTumor=Generates Creep allowing Zagara and her minions to move faster
ZagaraCreepTumorEndlessCreepTalent=Increases Creep Tumor's cast range and duration
ZagaraCreepTumorMalignantTumorTalent=Decreased Creep Tumor cooldown, Mana cost removed
ZagaraCreepTumorMetabolicBoostTalent=Increased Movement Speed bonus on Creep
ZagaraCreepTumorProtectiveCoating=Zagara takes less damage while on Creep
ZagaraCreepTumorReconstitutionTalent=Increased Health Regeneration on Creep
ZagaraDevouringMaw=Eats enemies in area
ZagaraDevouringMawTyrantMawTalent=More damage and cooldown reduction from Takedowns
ZagaraEnvenomedSpinesTalent=Add damage over time to your next Basic Attack
ZagaraHunterKiller=Unleash a Hydralisk on an enemy
ZagaraHunterKillerBroodExpansionTalent=Reduces the cooldown of Hunter Killer
ZagaraHunterKillerGroovedSpinesTalent=Increased Hunter Killer range and damage
ZagaraHunterKillerMutaliskTalent=Hunter Killer summons a Mutalisk instead
ZagaraHydraliskTransfusionTalent=Hunter Killer attacks restore Health
ZagaraInfest=Increases nearby allied Ranged Minion's damage
ZagaraInfestItem=Increases nearby allied Ranged Minion's damage
ZagaraInfestedDrop=Bombard an area with a Zerg Drop Pod that spawns Roachlings
ZagaraInfestedDropBileDropTalent=<c val="#TooltipQuest">Quest:</c> Infested Drop impacts increase damage
ZagaraInfestedDropBileDropTalentToken=<c val="#TooltipQuest">Quest:</c> Infested Drop impacts increase damage
ZagaraInfestedDropBileDropTalentTokenComplete=<c val="#TooltipQuest">Quest:</c> Infested Drop impacts increase damage
ZagaraInfestedDropCorpseFeedersTalent=Infested Drop cooldown is reduced and Roachlings take less damage
ZagaraMedusaBladesTalent=Basic Attacks hit 3 additional targets
ZagaraNydusNetwork=Empowers Creep and can create Nydus Worms
ZagaraNydusNetworkBroodlingNestTalent=Spawn broodlings when exiting a Nydus Worm
ZagaraRapidIncubation=Channel to regenerate Health and Mana
ZagaraSerratedSpines=<c val="#TooltipQuest">Quest:</c> Basic Attacks against Heroes increase damage
ZagaraViscousAcid=Banelings also slow enemies
ZaryaDefensiveShieldingTalent=Personal Barrier and Shield Ally grant Block
ZaryaEnergy=Damage absorbed by Zarya's Shields increase her damage.
ZaryaEnergyBornInBattleTalent=Reduces cooldowns at high Energy
ZaryaEnergyEnduranceTrainingTalent=Gain Resistant at high Energy
ZaryaEnergyHitMeTalent=Shield damage absorbed contributes more Energy
ZaryaEnergyMaximumChargeCompleteTalent=Regen globes now regenerate Energy<n/><c val="#TooltipQuest">QUEST COMPLETE!</c><n/>Maximum Energy is increased
ZaryaEnergyMaximumChargeTalent=Regen Globes grant Energy<n/><c val="#TooltipQuest">Quest</c>: Increases maximum Energy
ZaryaEnergyTogetherWeAreStrongTalent=Ally damage contributes to your shields
ZaryaExpulsionZone=Launch a bomb that continually pushes enemies
ZaryaExpulsionZoneClearOutTalent=Increases Expulsion Zone radius and provides Energy
ZaryaGravitonSurge=Launch a gravity bomb that draws in enemies
ZaryaGravitonSurgeGravityKillsTalent=Graviton Surge has increased duration and deals damage
ZaryaPainIsTemporaryTalent=Consume Energy to gain a shield
ZaryaParticleGrenade=Deals damage to enemies in a small area
ZaryaParticleGrenadeDemolitionsExpertComplete=<c val="#TooltipQuest">QUEST COMPLETE!</c><n/>Recharge rate is reduced and effect radius is increased
ZaryaParticleGrenadeDemolitionsExpertCompleteTalent=<c val="#TooltipQuest">QUEST COMPLETE!</c><n/>Recharge rate is reduced and effect radius is increased
ZaryaParticleGrenadeDemolitionsExpertTalent=<c val="#TooltipQuest">Quest</c>: Increases Particle Grenade radius and reduces cooldown
ZaryaParticleGrenadeGrenadierTalent=Particle Grenade charges are returned at once
ZaryaParticleGrenadePinpointAccuracyTalent=Particle Grenade deals more damage in center area
ZaryaParticleGrenadePlasmaShockTalent=Particle Grenade slows enemies near the center
ZaryaPersonalBarrier=Gain a shield that absorbs damage
ZaryaPersonalBarrierExplosiveBarrierTalent=Personal Barrier deals area damage
ZaryaPersonalBarrierIAmTheStrongestTalent=Increases Personal Barrier shield amount
ZaryaPersonalBarrierSpellBarrierTalent=Personal Barrier grants Spell Shield
ZaryaPersonalBarrierUnstoppableCompetitorTalent=Personal Barrier grants Unstoppable
ZaryaShieldAlly=Grant an ally a shield that absorbs damage
ZaryaShieldAllyCleansingShieldTalent=Shield Ally removes all disabling effects
ZaryaShieldAllyGainTrainTalent=Shield Ally now affects a second ally
ZaryaShieldAllyGiveMeTwentyCompleteTalent=<c val="#TooltipQuest">QUEST COMPLETE!</c><n/>Shield Ally shield amount increased and cooldown permanently reduced
ZaryaShieldAllyGiveMeTwentyTalent=<c val="#TooltipQuest">Quest</c>: Increases Shield Ally absorb amount and reduces cooldown
ZaryaShieldAllySpeedBarrierTalent=Shield Ally increases allied Hero Movement Speed
ZaryaShieldAllyTogetherWeAreStrongTalent=Allied damage dealt with Shield Ally contributes to Energy
ZaryaUnyieldingDefenderTalent=Activate to reset Shield cooldowns
ZaryaWeaponFeelTheHeatTalent=Basic Attack deals more damage to close enemies
ZaryaWeaponToTheLimitTalent=Increases Basic Attack size at high Energy
ZeratulBlink=Teleport to a location. Ability does not break cloak
ZeratulBlinkRapidDisplacementTalent=Reduces cooldown of Blink
ZeratulBlinkWormholeTalent=Can return from Blink location
ZeratulCleave=Damage nearby enemies
ZeratulCleaveGreaterCleaveTalent=Increases radius of Cleave
ZeratulCleaveRendingCleaveTalent=Deals additional damage over time
ZeratulMasterWarpBlade=Every third Basic Attack to a target does bonus damage
ZeratulPermanentCloak=Become Stealthed while not attacking, using Abilities, or taking damage
ZeratulPermanentCloakAssassinsBladeTalent=Increases Move Speed while Stealthed and damage when leaving Stealth
ZeratulShadowAssault=Basic Attacks charge enemies
ZeratulShadowAssaultNerazimFuryTalent=Grants Life Steal and increased duration
ZeratulSingularitySpike=Slow and damage the first enemy hit
ZeratulSingularitySpikeDoubleBombsTalent=Can cast Singularity Spike twice
ZeratulSingularitySpikeShadowSpikeTalent=No decloak and increased range on Singularity Spike
ZeratulSingularitySpikeSustainedAnomalyTalent=Deals area damage and slow
ZeratulVoidPrison=Trap targets in an area, making them Invulnerable
ZeratulVoidPrisonProtectivePrisonTalent=Allies not affected by Void Prison
ZeratulVoidSlashTalent=Deals more damage while cloaked
ZeratulVorpalBladeHotbar=Teleport to last attacked enemy
